_id,report_date,previous_day_total_doses_administered,previous_day_at_least_one,previous_day_fully_vaccinated,previous_day_3doses,total_doses_administered,total_individuals_at_least_one,total_individuals_partially_vaccinated,total_doses_in_fully_vaccinated_individuals,total_individuals_fully_vaccinated,total_individuals_3doses
1,2021-01-01T00:00:00,6254,6244,2,,32253,32197,32186,22,11,
2,2021-01-02T00:00:00,4618,4606,6,,36871,36751,36738,26,13,
3,2021-01-03T00:00:00,5397,5389,4,,42268,42138,42123,30,15,
4,2021-01-04T00:00:00,5998,5995,0,,48266,48132,48118,28,14,
5,2021-01-05T00:00:00,9691,9666,21,,57957,57796,57762,68,34,
6,2021-01-06T00:00:00,12800,12334,451,,70757,70127,69645,964,482,
7,2021-01-07T00:00:00,16229,15516,699,,86986,85642,84461,2362,1181,
8,2021-01-08T00:00:00,18045,17028,1004,,105031,102670,100485,4370,2185,
9,2021-01-09T00:00:00,19514,18434,1067,,124545,121102,117851,6502,3251,
10,2021-01-10T00:00:00,11376,11334,40,,135921,132427,129137,6580,3290,
11,2021-01-11T00:00:00,11716,11664,49,,147637,144090,140751,6678,3339,
12,2021-01-12T00:00:00,14483,14174,301,,162120,158255,154616,7278,3639,
13,2021-01-13T00:00:00,15447,13820,1597,,177567,172061,166827,10468,5234,
14,2021-01-14T00:00:00,19201,16747,2438,,196768,188802,181131,15342,7671,
15,2021-01-15T00:00:00,20089,18031,2038,,216857,206822,197113,19418,9709,
16,2021-01-16T00:00:00,17124,15939,1172,,233981,222745,211864,21762,10881,
17,2021-01-17T00:00:00,11272,10028,1237,,245253,232758,220642,24232,12116,
18,2021-01-18T00:00:00,6803,6719,74,,252056,239453,227267,24372,12186,
19,2021-01-19T00:00:00,11839,9729,2096,,263895,249161,234879,28564,14282,
20,2021-01-20T00:00:00,10817,7227,3573,,274712,256365,238511,35708,17854,
21,2021-01-21T00:00:00,10984,6861,4095,,285696,263210,241261,43898,21949,
22,2021-01-22T00:00:00,9050,4331,4699,,294746,267504,240858,53292,26646,
23,2021-01-23T00:00:00,7480,3061,4391,,302226,270535,239499,62072,31036,
24,2021-01-24T00:00:00,4401,1839,2541,,306627,272356,238779,67154,33577,
25,2021-01-25T00:00:00,5332,1056,4267,,311959,273380,235537,75686,37843,
26,2021-01-26T00:00:00,9411,2879,6503,,321370,276227,231882,88690,44345,
27,2021-01-27T00:00:00,9907,2869,7009,,331277,279067,227714,102706,51353,
28,2021-01-28T00:00:00,13143,5760,7339,,344420,284794,226102,117384,58692,
29,2021-01-29T00:00:00,10731,3315,7379,,355151,288078,222008,132140,66070,
30,2021-01-30T00:00:00,9214,2747,6428,,364365,290782,218288,144988,72494,
31,2021-01-31T00:00:00,3393,1576,1770,,367758,292324,218061,148526,74263,
32,2021-02-01T00:00:00,2133,494,1611,,369891,292783,216914,151738,75869,
33,2021-02-02T00:00:00,4431,1376,2997,,374322,294121,215259,157724,78862,
34,2021-02-03T00:00:00,6261,1738,4460,,380583,295818,212503,166630,83315,
35,2021-02-04T00:00:00,9110,1734,7295,,389693,297509,206905,181208,90604,
36,2021-02-05T00:00:00,8470,1486,6905,,398163,298955,201452,195006,97503,
37,2021-02-06T00:00:00,10681,1881,8739,,408844,300781,194548,212466,106233,
38,2021-02-07T00:00:00,7588,1736,5797,,416432,302477,190459,224036,112018,
39,2021-02-08T00:00:00,8231,3099,5083,,424663,305528,188440,234176,117088,
40,2021-02-09T00:00:00,15028,3872,11087,,439691,309358,181199,256318,128159,
41,2021-02-10T00:00:00,15530,4947,10521,,455221,314253,175598,277310,138655,
42,2021-02-11T00:00:00,16376,3905,12412,,471597,318106,167070,302072,151036,
43,2021-02-12T00:00:00,17698,2113,15530,,489295,320180,153634,333092,166546,
44,2021-02-13T00:00:00,16224,2451,13755,,505519,322586,142304,360564,180282,
45,2021-02-14T00:00:00,12892,929,11929,,518411,323467,131286,384362,192181,
46,2021-02-15T00:00:00,7870,487,7332,,526281,323906,124419,398974,199487,
47,2021-02-16T00:00:00,6009,1048,4906,,532290,324911,120541,408740,204370,
48,2021-02-17T00:00:00,10179,1615,8530,,542469,326482,113610,425744,212872,
49,2021-02-18T00:00:00,13894,2970,10875,,556363,329404,105687,447434,223717,
50,2021-02-19T00:00:00,18505,6219,12215,,574868,335571,99670,471802,235901,
51,2021-02-20T00:00:00,22640,11139,11448,,597508,346647,99336,494622,247311,
52,2021-02-21T00:00:00,17253,10391,6828,,614761,356978,102881,508194,254097,
53,2021-02-22T00:00:00,13596,8762,4778,,628357,365671,106845,517652,258826,
54,2021-02-23T00:00:00,17886,11134,6679,,646243,376749,111280,530938,265469,
55,2021-02-24T00:00:00,18599,13628,4887,,664842,390321,120007,540628,270314,
56,2021-02-25T00:00:00,20823,16494,4270,,685665,406749,132213,549072,274536,
57,2021-02-26T00:00:00,24939,21852,3024,,710604,428541,151018,555046,277523,
58,2021-02-27T00:00:00,27488,23595,3849,,738092,452072,170748,562648,281324,
59,2021-02-28T00:00:00,20599,19155,1409,,758691,471173,188482,565382,282691,
60,2021-03-01T00:00:00,18237,17040,1148,,776928,488151,204359,567584,283792,
61,2021-03-02T00:00:00,24716,22294,2334,,801644,510384,224304,572160,286080,
62,2021-03-03T00:00:00,30630,27988,2584,,832274,538321,249690,577262,288631,
63,2021-03-04T00:00:00,34734,32488,2157,,867008,570743,280005,581476,290738,
64,2021-03-05T00:00:00,40051,38199,1800,,907059,608894,316390,585008,292504,
65,2021-03-06T00:00:00,44200,41982,2177,,951259,650821,356181,589280,294640,
66,2021-03-07T00:00:00,32758,31571,1181,,984017,682318,386555,591526,295763,
67,2021-03-08T00:00:00,24055,22179,1863,,1008072,704429,406857,595144,297572,
68,2021-03-09T00:00:00,33333,29878,3427,,1041405,734241,433288,601906,300953,
69,2021-03-10T00:00:00,38387,34119,4221,,1079792,768286,463160,610252,305126,
70,2021-03-11T00:00:00,44022,40744,3239,,1123814,808964,500651,616626,308313,
71,2021-03-12T00:00:00,47754,46039,1691,,1171568,854939,544985,619908,309954,
72,2021-03-13T00:00:00,57972,55089,2858,,1229540,909957,597199,625516,312758,
73,2021-03-14T00:00:00,43462,42220,1225,,1273002,952094,638179,627830,313915,
74,2021-03-15T00:00:00,32830,31131,1683,,1305832,983166,667611,631110,315555,
75,2021-03-16T00:00:00,54002,51694,2289,,1359834,1034795,716994,635602,317801,
76,2021-03-17T00:00:00,61118,58575,2498,,1420952,1093304,773055,640498,320249,
77,2021-03-18T00:00:00,61592,59119,2444,,1482544,1152351,829711,645280,322640,
78,2021-03-19T00:00:00,64517,61180,3278,,1547061,1213452,887588,651728,325864,
79,2021-03-20T00:00:00,62621,60023,2564,,1609682,1273419,945039,656760,328380,
80,2021-03-21T00:00:00,44031,42501,1544,,1653713,1315855,985968,659774,329887,
81,2021-03-22T00:00:00,31025,30056,980,,1684738,1345823,1015012,661622,330811,
82,2021-03-23T00:00:00,54660,51880,2730,,1739398,1397608,1064130,666956,333478,
83,2021-03-24T00:00:00,76495,73305,3143,,1815893,1470823,1134259,673128,336564,
84,2021-03-25T00:00:00,82968,80379,2539,,1898861,1551123,1212077,678092,339046,
85,2021-03-26T00:00:00,87074,83532,3503,,1985935,1634574,1292077,684994,342497,
86,2021-03-27T00:00:00,80912,77951,2875,,2066847,1712422,1367115,690614,345307,
87,2021-03-28T00:00:00,67035,65435,1563,,2133882,1777767,1430954,693626,346813,
88,2021-03-29T00:00:00,51770,49073,2656,,2185652,1826760,1477337,698846,349423,
89,2021-03-30T00:00:00,73633,70212,3356,,2259285,1896895,1544157,705476,352738,
90,2021-03-31T00:00:00,93214,89548,3598,,2352499,1986345,1630062,712566,356283,
91,2021-04-01T00:00:00,89387,85494,3849,,2441886,2071741,1711662,720158,360079,
92,2021-04-02T00:00:00,93161,88924,4218,,2535047,2160579,1796334,728490,364245,
93,2021-04-03T00:00:00,61044,59357,1737,,2596091,2219845,1853914,731862,365931,
94,2021-04-04T00:00:00,72358,70695,1656,,2668449,2290429,1922900,735058,367529,
95,2021-04-05T00:00:00,53752,53276,474,,2722201,2343621,1975666,735910,367955,
96,2021-04-06T00:00:00,79629,77737,1901,,2801830,2421256,2051454,739604,369802,
97,2021-04-07T00:00:00,108068,104974,3072,,2909898,2526105,2153289,745632,372816,
98,2021-04-08T00:00:00,114141,110151,4036,,3024039,2636145,2259349,753592,376796,
99,2021-04-09T00:00:00,109909,105661,4312,,3133948,2741688,2360645,762086,381043,
100,2021-04-10T00:00:00,109311,105532,3867,,3243259,2847092,2462248,769688,384844,
101,2021-04-11T00:00:00,98666,95539,3266,,3341925,2942506,2554455,776102,388051,
102,2021-04-12T00:00:00,76094,75024,1162,,3418019,3017382,2628237,778290,389145,
103,2021-04-13T00:00:00,99535,96134,3413,,3517554,3113407,2720897,785020,392510,
104,2021-04-14T00:00:00,117109,113331,3660,,3634663,3226620,2830490,792260,396130,
105,2021-04-15T00:00:00,113619,109542,3908,,3748282,3336036,2936055,799962,399981,
106,2021-04-16T00:00:00,118143,113749,4211,,3866425,3449675,3045527,808296,404148,
107,2021-04-17T00:00:00,112473,107863,4464,,3978898,3557404,3148851,817106,408553,
108,2021-04-18T00:00:00,88794,86540,2116,,4067692,3643821,3233206,821230,410615,
109,2021-04-19T00:00:00,69004,67462,1458,,4136696,3711153,3299131,824044,412022,
110,2021-04-20T00:00:00,102167,98821,3136,,4238863,3809812,3394719,830186,415093,
111,2021-04-21T00:00:00,142123,137816,4068,,4380986,3947454,3528361,838186,419093,
112,2021-04-22T00:00:00,139567,135387,3931,,4520553,4082712,3659744,845936,422968,
113,2021-04-23T00:00:00,138287,131830,6205,,4658840,4214388,3785273,858230,429115,
114,2021-04-24T00:00:00,130359,126273,3909,,4789199,4340513,3907545,865936,432968,
115,2021-04-25T00:00:00,102057,98630,3189,,4891256,4438995,4002905,872180,436090,
116,2021-04-26T00:00:00,71031,69315,1564,,4962287,4508179,4070585,875188,437594,
117,2021-04-27T00:00:00,98562,95455,2910,,5060849,4603473,4163032,880882,440441,
118,2021-04-28T00:00:00,120635,115988,4447,,5181484,4719293,4274477,889632,444816,
119,2021-04-29T00:00:00,124562,119327,5070,,5306046,4838453,4388636,899634,449817,
120,2021-04-30T00:00:00,115891,110602,5038,,5421937,4948882,4494104,909556,454778,
121,2021-05-01T00:00:00,111359,107466,3668,,5533296,5056167,4597798,916738,458369,
122,2021-05-02T00:00:00,79190,76199,2876,,5612486,5132209,4671030,922358,461179,
123,2021-05-03T00:00:00,56815,55139,1599,,5669301,5187193,4724475,925436,462718,
124,2021-05-04T00:00:00,91991,88597,3304,,5761292,5275612,4809667,931890,465945,
125,2021-05-05T00:00:00,138059,133340,4627,,5899351,5408783,4938274,941018,470509,
126,2021-05-06T00:00:00,141899,136922,4834,,6041250,5545521,5070240,950562,475281,
127,2021-05-07T00:00:00,150360,145294,4855,,6191610,5690655,5210578,960154,480077,
128,2021-05-08T00:00:00,142537,137821,4460,,6334147,5828280,5343822,968916,484458,
129,2021-05-09T00:00:00,124890,121211,3502,,6459037,5949327,5461431,975792,487896,
130,2021-05-10T00:00:00,97849,95846,1894,,6556886,6044984,5555261,979446,489723,
131,2021-05-11T00:00:00,113604,108902,4508,,6670490,6153684,5659524,988320,494160,
132,2021-05-12T00:00:00,145119,138060,6903,,6815609,6291565,5790568,1001994,500997,
133,2021-05-13T00:00:00,142794,135382,7248,,6958403,6426772,5918601,1016342,508171,
134,2021-05-14T00:00:00,148927,138827,9928,,7107330,6565411,6047377,1036068,518034,
135,2021-05-15T00:00:00,159823,149745,9892,,7267153,6714969,6187118,1055702,527851,
136,2021-05-16T00:00:00,144420,136139,8071,,7411573,6850940,6315098,1071684,535842,
137,2021-05-17T00:00:00,115028,110923,3951,,7526601,6961674,6421957,1079434,539717,
138,2021-05-18T00:00:00,111413,100529,10677,,7638014,7062007,6511675,1100664,550332,
139,2021-05-19T00:00:00,149952,133518,16250,,7787966,7195373,6628865,1133016,566508,
140,2021-05-20T00:00:00,151658,131643,19789,,7939624,7326827,6740599,1172456,586228,
141,2021-05-21T00:00:00,165480,140953,24262,,8105104,7467599,6857186,1220826,610413,
142,2021-05-22T00:00:00,199555,172328,26989,,8304659,7639729,7002408,1274642,637321,
143,2021-05-23T00:00:00,139903,127509,12239,,8444562,7767060,7117562,1298996,649498,
144,2021-05-24T00:00:00,100342,93359,6833,,8544904,7860246,7203985,1312522,656261,
145,2021-05-25T00:00:00,90541,83035,7287,,8635445,7943118,7279637,1326962,663481,
146,2021-05-26T00:00:00,139889,113082,26534,,8775334,8056013,7366068,1379890,689945,
147,2021-05-27T00:00:00,152131,123094,28785,,8927465,8178950,7460289,1437322,718661,
148,2021-05-28T00:00:00,163945,132375,31260,,9091410,8311151,7561290,1499722,749861,
149,2021-05-29T00:00:00,153453,117173,36048,,9244863,8428174,7642321,1571706,785853,
150,2021-05-30T00:00:00,149790,119072,30485,,9394653,8547076,7730800,1632552,816276,
151,2021-05-31T00:00:00,99268,79863,19210,,9493921,8626769,7791347,1670844,835422,
152,2021-06-01T00:00:00,124267,90665,33260,,9618188,8717239,7848632,1737214,868607,
153,2021-06-02T00:00:00,145403,102207,42934,,9763591,8819265,7907793,1822944,911472,
154,2021-06-03T00:00:00,155463,99979,55201,,9919054,8919059,7952457,1933204,966602,
155,2021-06-04T00:00:00,181823,115600,65941,,10100877,9034460,8002005,2064910,1032455,
156,2021-06-05T00:00:00,172117,103494,68331,,10272994,9137755,8037055,2201400,1100700,
157,2021-06-06T00:00:00,163461,91910,71264,,10436455,9229487,8057593,2343788,1171894,
158,2021-06-07T00:00:00,119610,63088,56304,,10556065,9292378,8064255,2456246,1228123,
159,2021-06-08T00:00:00,161966,72501,89019,,10718031,9364690,8047628,2634124,1317062,
160,2021-06-09T00:00:00,181556,70866,110210,,10899587,9435379,8008188,2854382,1427191,
161,2021-06-10T00:00:00,185686,66480,118709,,11085273,9501656,7955847,3091618,1545809,
162,2021-06-11T00:00:00,204895,67573,136551,,11290168,9569043,7886765,3364556,1682278,
163,2021-06-12T00:00:00,199858,62741,136501,,11490026,9631602,7812915,3637374,1818687,
164,2021-06-13T00:00:00,190417,58943,130934,,11680443,9690370,7740829,3899082,1949541,
165,2021-06-14T00:00:00,137729,38719,98604,,11818172,9728893,7680853,4096080,2048040,
166,2021-06-15T00:00:00,189631,42658,146607,,12007803,9771332,7576782,4389100,2194550,
167,2021-06-16T00:00:00,206342,42475,163210,,12214145,9813611,7455954,4715314,2357657,
168,2021-06-17T00:00:00,210581,37992,171992,,12424726,9851388,7321831,5059114,2529557,
169,2021-06-18T00:00:00,217294,35410,181271,,12642020,9886608,7175872,5421472,2710736,
170,2021-06-19T00:00:00,215980,35533,179760,,12858000,9921935,7031551,5780768,2890384,
171,2021-06-20T00:00:00,186348,35616,150153,,13044348,9957353,6916924,6080858,3040429,
172,2021-06-21T00:00:00,120503,20870,99122,,13164851,9978028,6838569,6278918,3139459,
173,2021-06-22T00:00:00,205052,27581,176705,,13369903,10005415,6689360,6632110,3316055,
174,2021-06-23T00:00:00,230663,28694,201206,,13600566,10033909,6516756,7034306,3517153,
175,2021-06-24T00:00:00,227810,26732,200305,,13828376,10060445,6343097,7434696,3717348,
176,2021-06-25T00:00:00,251234,28039,222431,,14079610,10088282,6148622,7879320,3939660,
177,2021-06-26T00:00:00,261434,30073,230640,,14341044,10118129,5947970,8340318,4170159,
178,2021-06-27T00:00:00,205094,27841,176636,,14546138,10145789,5799103,8693372,4346686,
179,2021-06-28T00:00:00,199320,20985,177761,,14745458,10166576,5642254,9048644,4524322,
180,2021-06-29T00:00:00,250196,24529,224923,,14995654,10190864,5441773,9498182,4749091,
181,2021-06-30T00:00:00,275640,24218,250849,,15271294,10214879,5215068,9999622,4999811,
182,2021-07-01T00:00:00,272062,25344,246156,,15543356,10240005,4994177,10491656,5245828,
183,2021-07-02T00:00:00,144817,11624,132949,,15688173,10251455,4872780,10757350,5378675,
184,2021-07-03T00:00:00,216994,19969,196786,,15905167,10271202,4695890,11150624,5575312,
185,2021-07-04T00:00:00,196342,19539,176569,,16101509,10290554,4538793,11503522,5751761,
186,2021-07-05T00:00:00,148773,12471,136153,,16250282,10302835,4415049,11775572,5887786,
187,2021-07-06T00:00:00,220126,20031,199866,,16470408,10322650,4235144,12175012,6087506,
188,2021-07-07T00:00:00,246694,23003,223437,,16717102,10345427,4034632,12621590,6310795,
189,2021-07-08T00:00:00,231328,21417,209687,,16948430,10366638,3846291,13040694,6520347,
190,2021-07-09T00:00:00,227082,21539,205365,,17175512,10387975,3662395,13451160,6725580,
191,2021-07-10T00:00:00,209132,20560,188407,,17384644,10408331,3494481,13827700,6913850,
192,2021-07-11T00:00:00,171734,17599,154003,,17556378,10425729,3358023,14135412,7067706,
193,2021-07-12T00:00:00,123179,11462,111614,,17679557,10437002,3257819,14358366,7179183,
194,2021-07-13T00:00:00,178614,19089,159376,,17858171,10455869,3117465,14676808,7338404,
195,2021-07-14T00:00:00,180099,19332,160603,,18038270,10474986,2976142,14997688,7498844,
196,2021-07-15T00:00:00,167283,19621,147482,,18205553,10494396,2848234,15292324,7646162,
197,2021-07-16T00:00:00,169445,19948,149336,,18374998,10514142,2718797,15590690,7795345,
198,2021-07-17T00:00:00,173116,20325,152655,,18548114,10534218,2586410,15895616,7947808,
199,2021-07-18T00:00:00,133714,15969,117603,,18681828,10550003,2484740,16130526,8065263,
200,2021-07-19T00:00:00,92042,10440,81490,,18773870,10560230,2413652,16293156,8146578,
201,2021-07-20T00:00:00,133623,16996,116566,,18907493,10576986,2314018,16525936,8262968,
202,2021-07-21T00:00:00,140151,17011,123061,,19047644,10593782,2207915,16771734,8385867,
203,2021-07-22T00:00:00,125717,17705,107875,,19173361,10611263,2117698,16987130,8493565,
204,2021-07-23T00:00:00,120363,17033,103111,,19293724,10628055,2031578,17192954,8596477,
205,2021-07-24T00:00:00,126774,18361,108167,,19420498,10646213,1941732,17408962,8704481,
206,2021-07-25T00:00:00,103727,14909,88681,,19524225,10660898,1867917,17585962,8792981,
207,2021-07-26T00:00:00,66753,9924,56734,,19590978,10670605,1821070,17699070,8849535,
208,2021-07-27T00:00:00,92456,15351,76947,,19683434,10685695,1759430,17852530,8926265,
209,2021-07-28T00:00:00,94028,16505,77448,,19777462,10701965,1698443,18007044,9003522,
210,2021-07-29T00:00:00,89496,16758,72570,,19866958,10718491,1642587,18151808,9075904,
211,2021-07-30T00:00:00,84153,16142,67890,,19951111,10734405,1590799,18287212,9143606,
212,2021-07-31T00:00:00,83955,15776,68031,,20035066,10749963,1538516,18422894,9211447,
213,2021-08-01T00:00:00,61934,11349,50399,,20097000,10761086,1499431,18523310,9261655,
214,2021-08-02T00:00:00,42557,7452,34980,,20139557,10768339,1471871,18592936,9296468,
215,2021-08-03T00:00:00,33373,6002,27191,,20172930,10774108,1450659,18646898,9323449,
216,2021-08-04T00:00:00,61403,12404,48799,,20234333,10786277,1414227,18744100,9372050,
217,2021-08-05T00:00:00,59529,12588,46780,,20293862,10798657,1379991,18837332,9418666,
218,2021-08-06T00:00:00,56094,11893,43983,,20349956,10810290,1347870,18924840,9462420,
219,2021-08-07T00:00:00,62433,12163,50077,,20412389,10822192,1309913,19024558,9512279,
220,2021-08-08T00:00:00,48793,9322,39268,,20461182,10831286,1279944,19102684,9551342,
221,2021-08-09T00:00:00,30907,5959,24763,,20492089,10837031,1261113,19151836,9575918,
222,2021-08-10T00:00:00,49348,10554,38481,,20541437,10847305,1233152,19228306,9614153,
223,2021-08-11T00:00:00,48784,10797,37731,,20590221,10857856,1206187,19303338,9651669,
224,2021-08-12T00:00:00,49339,11244,37855,,20639560,10868848,1179534,19378628,9689314,
225,2021-08-13T00:00:00,49704,11773,37652,,20689264,10880380,1153625,19453510,9726755,
226,2021-08-14T00:00:00,51288,12170,38904,,20740552,10892300,1126865,19530870,9765435,
227,2021-08-15T00:00:00,41852,9892,31726,,20782404,10901990,1105001,19593978,9796989,
228,2021-08-16T00:00:00,26787,6212,20418,,20809191,10907979,1090769,19634420,9817210,
229,2021-08-17T00:00:00,40576,11091,29207,,20849767,10918820,1072629,19692382,9846191,
230,2021-08-18T00:00:00,41959,12001,29707,,20891726,10930579,1054891,19751376,9875688,
231,2021-08-19T00:00:00,45955,16571,29124,,20937681,10946899,1042310,19809178,9904589,
232,2021-08-20T00:00:00,46529,16343,29771,,20984210,10962986,1028855,19868262,9934131,
233,2021-08-21T00:00:00,48009,15177,32468,,21032219,10977903,1011531,19932744,9966372,
234,2021-08-22T00:00:00,34476,10852,23343,,21066695,10988508,999016,19978984,9989492,
235,2021-08-23T00:00:00,23244,7014,16008,,21089939,10995287,990001,20010572,10005286,
236,2021-08-24T00:00:00,37703,13398,23838,,21127642,11008431,979538,20057786,10028893,
237,2021-08-25T00:00:00,41434,14453,26358,,21169076,11022628,967614,20110028,10055014,
238,2021-08-26T00:00:00,39337,13582,24999,,21208413,11035934,956162,20159544,10079772,
239,2021-08-27T00:00:00,37761,12989,23716,,21246174,11048682,945408,20206548,10103274,
240,2021-08-28T00:00:00,40224,13470,25551,,21286398,11061873,933303,20257140,10128570,
241,2021-08-29T00:00:00,30616,10278,19967,,21317014,11071919,923595,20296648,10148324,
242,2021-08-30T00:00:00,18272,6156,11857,,21335286,11077828,917865,20319926,10159963,
243,2021-08-31T00:00:00,32761,11957,19647,,21368047,11089517,910147,20358740,10179370,
244,2021-09-01T00:00:00,36340,12994,21993,,21404387,11102278,901132,20402292,10201146,
245,2021-09-02T00:00:00,37856,15672,19705,,21442243,11117698,897074,20441248,10220624,
246,2021-09-03T00:00:00,46970,21124,22477,,21489213,11138573,895702,20485742,10242871,
247,2021-09-04T00:00:00,46946,20615,24807,,21536159,11158942,891487,20534910,10267455,
248,2021-09-05T00:00:00,33138,14230,18603,,21569297,11172928,887094,20571668,10285834,
249,2021-09-06T00:00:00,21768,9507,12058,,21591065,11182186,884526,20595320,10297660,
250,2021-09-07T00:00:00,15072,6756,8125,,21606137,11188685,883140,20611090,10305545,
251,2021-09-08T00:00:00,41230,17157,20964,,21647367,11205578,879315,20652526,10326263,
252,2021-09-09T00:00:00,41546,17023,19717,,21688913,11222324,876596,20691456,10345728,
253,2021-09-10T00:00:00,39752,15556,19051,,21728665,11237617,873083,20729068,10364534,
254,2021-09-11T00:00:00,42458,15974,23365,,21771123,11253312,865671,20775282,10387641,
255,2021-09-12T00:00:00,30028,11551,17899,,21801151,11264569,859293,20810552,10405276,
256,2021-09-13T00:00:00,16120,6415,9198,,21817271,11270750,856495,20828510,10414255,
257,2021-09-14T00:00:00,29970,11580,15323,,21847241,11282027,852725,20858604,10429302,
258,2021-09-15T00:00:00,39346,14045,19458,,21886587,11295812,847296,20897032,10448516,
259,2021-09-16T00:00:00,39406,14014,19271,,21925993,11309591,842016,20935150,10467575,
260,2021-09-17T00:00:00,39014,13647,19382,,21965007,11322996,836269,20973454,10486727,
261,2021-09-18T00:00:00,41338,14119,23590,,22006345,11336842,826777,21020130,10510065,
262,2021-09-19T00:00:00,30715,10846,19010,,22037060,11347429,818600,21057658,10528829,
263,2021-09-20T00:00:00,16757,6105,10188,,22053817,11353280,814494,21077572,10538786,
264,2021-09-21T00:00:00,31424,11235,17024,,22085241,11364250,808689,21111122,10555561,
265,2021-09-22T00:00:00,41859,14832,22953,,22127100,11378786,800547,21156478,10578239,
266,2021-09-23T00:00:00,47285,16153,26056,,22174385,11394674,790625,21208098,10604049,
267,2021-09-24T00:00:00,46403,15667,26705,,22220788,11410081,779568,21261026,10630513,
268,2021-09-25T00:00:00,48276,15283,29985,,22269064,11425111,764847,21320528,10660264,
269,2021-09-26T00:00:00,37574,12442,24528,,22306638,11437278,752740,21369076,10684538,
270,2021-09-27T00:00:00,19189,6539,12338,,22325827,11443563,746925,21393276,10696638,
271,2021-09-28T00:00:00,31020,11313,17917,,22356847,11454617,740309,21428616,10714308,
272,2021-09-29T00:00:00,37956,12494,21764,,22394803,11466840,731019,21471642,10735821,
273,2021-09-30T00:00:00,37413,11675,21412,,22432216,11478256,721263,21513986,10756993,
274,2021-10-01T00:00:00,30951,9827,18452,,22463167,11487856,712625,21550462,10775231,
275,2021-10-02T00:00:00,37189,11169,23614,,22500356,11498755,700162,21597186,10798593,
276,2021-10-03T00:00:00,27234,8173,18338,,22527590,11506687,689984,21633406,10816703,
277,2021-10-04T00:00:00,14880,4750,9809,,22542470,11511189,684907,21652564,10826282,
278,2021-10-05T00:00:00,26911,8625,15918,,22569381,11519553,677599,21683908,10841954,
279,2021-10-06T00:00:00,31745,9654,18568,,22601126,11528948,668677,21720542,10860271,
280,2021-10-07T00:00:00,30412,9418,17146,,22631538,11538115,660936,21754358,10877179,
281,2021-10-08T00:00:00,32904,10762,18882,,22664442,11548606,652802,21791608,10895804,
282,2021-10-09T00:00:00,34202,10679,21048,,22698644,11559022,642419,21833206,10916603,
283,2021-10-10T00:00:00,23458,7673,15112,,22722102,11566444,634968,21862952,10931476,
284,2021-10-11T00:00:00,12029,3845,7881,,22734131,11570039,630916,21878246,10939123,
285,2021-10-12T00:00:00,5181,1648,3309,,22739312,11571409,629240,21884338,10942169,
286,2021-10-13T00:00:00,29177,9213,18121,,22768489,11580332,620316,21920032,10960016,
287,2021-10-14T00:00:00,29065,8914,17783,,22797554,11588969,611437,21955064,10977532,
288,2021-10-15T00:00:00,29165,8849,18203,,22826719,11597555,602070,21990970,10995485,
289,2021-10-16T00:00:00,31185,9000,19891,,22857904,11606264,591167,22030194,11015097,
290,2021-10-17T00:00:00,23758,7271,15402,,22881662,11613281,583023,22060516,11030258,
291,2021-10-18T00:00:00,12335,3751,8165,,22893997,11616751,578597,22076308,11038154,
292,2021-10-19T00:00:00,21338,6644,12672,,22915335,11623112,572556,22101112,11050556,
293,2021-10-20T00:00:00,25718,7548,14947,,22941053,11630413,565144,22130538,11065269,
294,2021-10-21T00:00:00,23240,6698,13062,,22964293,11636842,558769,22156146,11078073,
295,2021-10-22T00:00:00,26183,7329,15151,,22990476,11643848,550931,22185834,11092917,
296,2021-10-23T00:00:00,28239,7617,17188,,23018715,11651203,541353,22219700,11109850,
297,2021-10-24T00:00:00,19408,5736,12629,,23038123,11656683,534448,22244470,11122235,
298,2021-10-25T00:00:00,9947,2713,6484,,23048070,11659127,530669,22256916,11128458,
299,2021-10-26T00:00:00,18976,5406,11135,,23067046,11664255,524931,22278648,11139324,
300,2021-10-27T00:00:00,22915,6088,13247,,23089961,11670088,517758,22304660,11152330,
301,2021-10-28T00:00:00,22358,5802,12666,,23112319,11675602,510883,22329438,11164719,
302,2021-10-29T00:00:00,22874,5742,13083,,23135193,11681042,503527,22355030,11177515,
303,2021-10-30T00:00:00,24181,6064,14643,,23159374,11686834,494936,22383796,11191898,
304,2021-10-31T00:00:00,16521,4608,10622,,23175895,11691148,488917,22404462,11202231,
305,2021-11-01T00:00:00,7896,2088,5062,,23183791,11692956,485930,22414052,11207026,
306,2021-11-02T00:00:00,15664,4369,7772,,23199455,11697036,482516,22429040,11214520,
307,2021-11-03T00:00:00,18679,5080,9629,,23218134,11701813,477957,22447712,11223856,
308,2021-11-04T00:00:00,19550,4884,10058,,23237684,11706421,472768,22467306,11233653,
309,2021-11-05T00:00:00,21509,4411,9543,,23259193,11710543,467622,22485842,11242921,
310,2021-11-06T00:00:00,25380,5220,12170,,23284573,11715494,460655,22509678,11254839,
311,2021-11-07T00:00:00,21500,4039,8950,,23306073,11719252,455732,22527040,11263520,
312,2021-11-08T00:00:00,12003,2113,4740,,23318076,11721070,453089,22535962,11267981,
313,2021-11-09T00:00:00,24182,3865,7676,,23342258,11724614,449268,22550692,11275346,
314,2021-11-10T00:00:00,28535,4521,9028,,23370793,11728859,444747,22568224,11284112,
315,2021-11-11T00:00:00,28818,4326,9122,,23399611,11732888,439942,22585892,11292946,
316,2021-11-12T00:00:00,26821,4179,8285,,23426432,11736776,435822,22601908,11300954,
317,2021-11-13T00:00:00,34372,5094,11437,,23460804,11741564,429470,22624188,11312094,
318,2021-11-14T00:00:00,23262,3904,8632,,23484066,11745205,424735,22640940,11320470,
319,2021-11-15T00:00:00,12732,2196,4506,,23496798,11747141,422417,22649448,11324724,
320,2021-11-16T00:00:00,26243,3944,7519,,23523041,11750829,418838,22663982,11331991,
321,2021-11-17T00:00:00,31222,4057,7847,,23554263,11754604,415038,22679132,11339566,
322,2021-11-18T00:00:00,32563,3874,7555,,23586826,11758171,411343,22693656,11346828,
323,2021-11-19T00:00:00,35523,3873,7773,,23622349,11761743,407431,22708624,11354312,
324,2021-11-20T00:00:00,40159,4393,8836,,23662508,11765854,402979,22725750,11362875,
325,2021-11-21T00:00:00,28167,3448,6970,,23690675,11769040,399443,22739194,11369597,
326,2021-11-22T00:00:00,14927,1954,3907,,23705602,11770717,397484,22746466,11373233,
327,2021-11-23T00:00:00,33119,3291,6039,,23738721,11773728,394728,22758000,11379000,
328,2021-11-24T00:00:00,42731,3776,6835,,23781452,11777199,391658,22771082,11385541,
329,2021-11-25T00:00:00,46113,3947,6611,,23827565,11780871,388991,22783760,11391880,
330,2021-11-26T00:00:00,52922,11362,6640,,23880487,11791962,393706,22796512,11398256,
331,2021-11-27T00:00:00,63590,22372,7064,,23944077,11814053,409004,22810098,11405049,
332,2021-11-28T00:00:00,51504,27753,5341,,23995581,11841514,431404,22820220,11410110,
333,2021-11-29T00:00:00,33545,18935,2893,,24029126,11860188,447435,22825506,11412753,
334,2021-11-30T00:00:00,56110,20703,5165,,24085236,11880610,462963,22835294,11417647,
335,2021-12-01T00:00:00,69597,26255,5663,,24154833,11906559,483541,22846036,11423018,
336,2021-12-02T00:00:00,71693,26500,5061,,24226526,11932761,504967,22855588,11427794,
337,2021-12-03T00:00:00,73499,25115,5199,,24300025,11957580,524877,22865406,11432703,
338,2021-12-04T00:00:00,81244,27804,6110,47309,24381269,11985090,546562,,11438528,808379
339,2021-12-05T00:00:00,62682,31942,4434,26283,24443951,12016737,574062,,11442675,834558
340,2021-12-06T00:00:00,38648,19151,2720,16760,24482599,12035598,590486,,11445112,851240
341,2021-12-07T00:00:00,60345,14858,4509,40960,24542944,12050184,600825,,11449359,892126
342,2021-12-08T00:00:00,73517,19066,4701,49742,24616461,12068973,615180,,11453793,941790
343,2021-12-09T00:00:00,74560,18288,4366,51887,24691021,12086952,629094,,11457858,993592
344,2021-12-10T00:00:00,77590,17596,4688,55292,24768611,12104267,641997,,11462270,1048803
345,2021-12-11T00:00:00,83282,20419,5877,56969,24851893,12124397,656525,,11467872,1105686
346,2021-12-12T00:00:00,60808,22705,4180,33880,24912701,12146822,675044,,11471778,1139477
347,2021-12-13T00:00:00,34970,11604,2426,20917,24947671,12158129,684212,,11473917,1160299
348,2021-12-14T00:00:00,102059,9014,3891,89104,25049730,12166832,689320,,11477512,1249283
349,2021-12-15T00:00:00,127755,12441,4527,110746,25177485,12178969,697224,,11481745,1359929
350,2021-12-16T00:00:00,139457,12480,4278,122676,25316942,12191163,705416,,11485747,1482506
351,2021-12-17T00:00:00,159258,12411,4548,142273,25476200,12203299,713270,,11490029,1624682
352,2021-12-18T00:00:00,175663,13533,4951,157135,25651863,12216538,721840,,11494698,1781722
353,2021-12-19T00:00:00,140488,18165,3950,118334,25792351,12234402,736047,,11498355,1899945
354,2021-12-20T00:00:00,106864,10312,2752,93749,25899215,12244446,743597,,11500849,1993596
355,2021-12-21T00:00:00,215483,12969,4343,198144,26114698,12257099,752216,,11504883,2191619
356,2021-12-22T00:00:00,237362,14438,5222,217811,26352060,12271237,761418,,11509819,2409312
357,2021-12-23T00:00:00,257872,11741,5114,240911,26609932,12282671,768039,,11514632,2650117
358,2021-12-24T00:00:00,223719,9471,4605,209573,26833651,12291844,772901,,11518943,2859573
359,2021-12-25T00:00:00,89783,3898,2529,83366,26923434,12295467,774265,,11521202,2942832
360,2021-12-26T00:00:00,11913,391,366,11144,26935347,12295566,774282,,11521284,2953846
361,2021-12-27T00:00:00,46976,1493,1127,44324,26982323,12296814,774641,,11522173,2998050
362,2021-12-28T00:00:00,144857,6106,4034,134651,27127180,12302626,776702,,11525924,3132570
363,2021-12-29T00:00:00,175535,9383,4602,161477,27302715,12311713,781479,,11530234,3293919
364,2021-12-30T00:00:00,200150,10144,5375,184581,27502865,12321554,786233,,11535321,3478366
365,2021-12-31T00:00:00,195297,10019,5827,179195,27698162,12331284,790416,,11540868,3657435
366,2022-01-01T00:00:00,97005,5393,3898,87385,27795167,12336367,791903,,11544464,3744671
367,2022-01-02T00:00:00,19472,947,940,17452,27814639,12337023,791901,,11545122,3761977
368,2022-01-03T00:00:00,88284,4774,4600,78827,27902923,12341487,792067,,11549420,3840651
369,2022-01-04T00:00:00,146461,6025,5338,135053,28049384,12347184,792741,,11554443,3975548
370,2022-01-05T00:00:00,177621,7672,7326,162448,28227005,12354502,793076,,11561426,4137836
371,2022-01-06T00:00:00,191650,7236,6809,177068,28418655,12361419,793492,,11567927,4314749
372,2022-01-07T00:00:00,191414,7993,7035,175563,28610069,12369068,794438,,11574630,4490139
373,2022-01-08T00:00:00,181800,8660,6678,165272,28791869,12377396,796407,,11580989,4655255
374,2022-01-09T00:00:00,131168,9883,7211,113980,28923037,12386957,799074,,11587883,4769075
375,2022-01-10T00:00:00,90603,5113,4495,80861,29013640,12391747,799682,,11592065,4849783
376,2022-01-11T00:00:00,139014,6189,6621,125496,29152654,12397589,799237,,11598352,4975089
377,2022-01-12T00:00:00,157145,8189,8084,138745,29309799,12405449,799337,,11606112,5113666
378,2022-01-13T00:00:00,162776,9228,9235,141594,29472575,12414315,799316,,11614999,5255077
379,2022-01-14T00:00:00,159994,10775,10409,136113,29632569,12424728,799677,,11625051,5390992
380,2022-01-15T00:00:00,161297,11027,11696,135940,29793866,12435383,798997,,11636386,5526739
381,2022-01-16T00:00:00,109859,9308,9707,89482,29903725,12444329,798591,,11645738,5616003
382,2022-01-17T00:00:00,65829,5951,6577,52655,29969554,12449944,797955,,11651989,5668473
383,2022-01-18T00:00:00,36221,2038,2162,31196,30005775,12451626,797820,,11653806,5699473
384,2022-01-19T00:00:00,101405,5611,6744,85988,30107180,12456837,796669,,11660168,5785234
385,2022-01-20T00:00:00,103700,6348,7027,85786,30210880,12462801,795982,,11666819,5870797
386,2022-01-21T00:00:00,102204,6255,8079,82552,30313084,12468652,794144,,11674508,5953121
387,2022-01-22T00:00:00,102670,8740,12094,78159,30415754,12477003,790783,,11686220,6031052
388,2022-01-23T00:00:00,76773,7329,14013,54831,30492527,12483989,784092,,11699897,6085661
389,2022-01-24T00:00:00,42302,3201,7947,30761,30534829,12486826,779328,,11707498,6116215
390,2022-01-25T00:00:00,62650,3776,8395,48153,30597479,12490219,774694,,11715525,6164147
391,2022-01-26T00:00:00,77959,4943,13186,55719,30675438,12494785,766446,,11728339,6219624
392,2022-01-27T00:00:00,78133,4904,13266,56076,30753571,12499317,758074,,11741243,6275463
393,2022-01-28T00:00:00,77359,4699,13695,53918,30830930,12503658,749065,,11754593,6329162
394,2022-01-29T00:00:00,84904,5543,17741,58149,30915834,12508837,736860,,11771977,6387066
395,2022-01-30T00:00:00,66567,5047,20650,40172,30982401,12513543,721243,,11792300,6427014
396,2022-01-31T00:00:00,34789,2182,9907,22360,31017190,12515405,713509,,11801896,6449184
397,2022-02-01T00:00:00,51406,3286,9673,36554,31068596,12518338,707112,,11811226,6485513
398,2022-02-02T00:00:00,57787,3868,12423,38701,31126383,12521874,698542,,11823332,6524013
399,2022-02-03T00:00:00,52634,3622,11524,34323,31179017,12525117,690628,,11834489,6558084
400,2022-02-04T00:00:00,43167,2966,10588,27306,31222184,12527771,682996,,11844775,6585195
401,2022-02-05T00:00:00,58790,3761,14497,37584,31280974,12531200,672248,,11858952,6622566
402,2022-02-06T00:00:00,49921,3655,16128,29602,31330895,12534532,659770,,11874762,6651944
403,2022-02-07T00:00:00,23271,1700,7825,13453,31354166,12535906,653632,,11882274,6665173
404,2022-02-08T00:00:00,33471,2378,7271,21992,31387637,12537954,648732,,11889222,6686932
405,2022-02-09T00:00:00,38950,2805,8935,24428,31426587,12540400,642596,,11897804,6711108
406,2022-02-10T00:00:00,37599,2779,8853,22573,31464186,12542842,636518,,11906324,6733450
407,2022-02-11T00:00:00,39497,2732,10310,23019,31503683,12545226,628930,,11916296,6756230
408,2022-02-12T00:00:00,42115,2971,11475,25345,31545798,12547863,620415,,11927448,6781351
409,2022-02-13T00:00:00,36375,2816,13158,19954,31582173,12550392,610070,,11940322,6801107
410,2022-02-14T00:00:00,17007,1180,6131,9484,31599180,12551296,605111,,11946185,6810390
411,2022-02-15T00:00:00,19417,1399,4771,11895,31618597,12552371,601729,,11950642,6822058
412,2022-02-16T00:00:00,26087,1780,7756,14969,31644684,12553854,595749,,11958105,6836826
413,2022-02-17T00:00:00,26816,1694,7546,14995,31671500,12555193,589888,,11965305,6851566
414,2022-02-18T00:00:00,24000,1360,6629,13701,31695500,12556235,584607,,11971628,6865058
415,2022-02-19T00:00:00,37883,1912,8350,26072,31733383,12557814,578164,,11979650,6890887
416,2022-02-20T00:00:00,32620,1505,7978,22820,31766003,12559018,571683,,11987335,6913502
417,2022-02-21T00:00:00,17519,916,3682,12766,31783522,12559637,568908,,11990729,6926055
418,2022-02-22T00:00:00,9143,441,1563,6966,31792665,12559788,567781,,11992007,6932810
419,2022-02-23T00:00:00,25395,1338,4818,17308,31818060,12560816,564294,,11996522,6949882
420,2022-02-24T00:00:00,24604,1408,5243,15489,31842664,12561901,560454,,12001447,6965128
421,2022-02-25T00:00:00,23142,1400,5147,14522,31865806,12563007,556700,,12006307,6979424
422,2022-02-26T00:00:00,25275,1393,5922,16571,31891081,12564090,552164,,12011926,6995769
423,2022-02-27T00:00:00,26984,1374,7382,17710,31918065,12565195,546145,,12019050,7013284
424,2022-02-28T00:00:00,10134,595,2531,6746,31928199,12565536,544201,,12021335,7019847
425,2022-03-01T00:00:00,13236,959,3165,8175,31941435,12566189,541985,,12024204,7027804
426,2022-03-02T00:00:00,15444,1170,3587,9629,31956879,12567096,539561,,12027535,7037254
427,2022-03-03T00:00:00,14327,1086,3235,8695,31971206,12567870,537404,,12030466,7045718
428,2022-03-04T00:00:00,14514,995,3458,8331,31985720,12568544,534937,,12033607,7053796
429,2022-03-05T00:00:00,18565,1280,5009,11200,32004285,12569514,531197,,12038317,7064772
430,2022-03-06T00:00:00,16546,1094,5532,9614,32020831,12570326,526753,,12043573,7074178
431,2022-03-07T00:00:00,5961,472,1858,3513,32026792,12570513,525360,,12045153,7077474
432,2022-03-08T00:00:00,7385,704,1949,4162,32034177,12570938,524107,,12046831,7081437
433,2022-03-09T00:00:00,11208,916,2747,6417,32045385,12571578,522270,,12049308,7087652
434,2022-03-10T00:00:00,12794,1046,3269,6848,32058179,12572347,520040,,12052307,7094287
435,2022-03-11T00:00:00,12925,916,3423,6877,32071104,12572974,517525,,12055449,7100948
436,2022-03-12T00:00:00,14725,1054,4207,8314,32085829,12573756,514369,,12059387,7109058
437,2022-03-13T00:00:00,14789,1094,5011,8350,32100618,12574558,510447,,12064111,7117171
438,2022-03-14T00:00:00,6343,452,2233,3501,32106961,12574738,508663,,12066075,7120458
439,2022-03-15T00:00:00,10228,798,2638,5982,32117189,12575245,506811,,12068434,7126225
440,2022-03-16T00:00:00,13097,943,3676,6962,32130286,12575898,504075,,12071823,7132956
441,2022-03-17T00:00:00,13227,1054,3973,6767,32143513,12576664,501149,,12075515,7139503
442,2022-03-18T00:00:00,11933,919,3156,6440,32155446,12577280,498902,,12078378,7145719
443,2022-03-19T00:00:00,14466,1007,4171,7913,32169912,12578007,495736,,12082271,7153413
444,2022-03-20T00:00:00,11767,994,3965,6379,32181679,12578729,492760,,12085969,7159584
445,2022-03-21T00:00:00,5065,418,1588,2814,32186744,12578888,491586,,12087302,7162195
446,2022-03-22T00:00:00,6742,556,1565,3900,32193486,12579156,490571,,12088585,7165879
447,2022-03-23T00:00:00,10003,791,2314,5205,32203489,12579631,489045,,12090586,7170843
448,2022-03-24T00:00:00,9315,726,2379,4623,32212804,12580093,487383,,12092710,7175262
449,2022-03-25T00:00:00,9256,786,2164,4763,32222060,12580616,485997,,12094619,7179813
450,2022-03-26T00:00:00,10959,940,2844,5514,32233019,12581279,484091,,12097188,7185108
451,2022-03-27T00:00:00,10243,913,3545,5304,32243262,12581932,481455,,12100477,7190201
452,2022-03-28T00:00:00,3595,324,1111,1992,32246857,12582015,480665,,12101350,7191998
453,2022-03-29T00:00:00,5369,502,1225,2695,32252226,12582232,479936,,12102296,7194471
454,2022-03-30T00:00:00,7870,748,1847,4127,32260096,12582700,478832,,12103868,7198372
455,2022-03-31T00:00:00,8680,695,1934,4419,32268776,12583105,477587,,12105518,7202568
456,2022-04-01T00:00:00,9340,805,1925,4898,32278116,12583619,476458,,12107161,7207228
457,2022-04-02T00:00:00,10462,889,2221,5580,32288578,12584222,475114,,12109108,7212592
458,2022-04-03T00:00:00,9226,883,2572,5069,32297804,12584848,473419,,12111429,7217459
459,2022-04-04T00:00:00,4218,388,1009,2410,32302022,12584974,472795,,12112179,7219665
460,2022-04-05T00:00:00,6104,603,1045,3061,32308126,12585236,472347,,12112889,7222450
461,2022-04-06T00:00:00,8411,721,1493,4385,32316537,12585666,471570,,12114096,7226608
462,2022-04-07T00:00:00,10370,736,1693,4840,32326907,12586102,470608,,12115494,7231205
463,2022-04-08T00:00:00,24027,817,1593,4845,32350934,12586641,469826,,12116815,7235834
464,2022-04-09T00:00:00,30523,974,1980,5904,32381457,12587317,468811,,12118506,7241515
465,2022-04-10T00:00:00,24890,978,2401,5340,32406347,12588036,467382,,12120654,7246653
466,2022-04-11T00:00:00,12592,386,881,2435,32418939,12588171,466883,,12121288,7248886
467,2022-04-12T00:00:00,28176,698,1031,3543,32447115,12588566,466543,,12122023,7252197
468,2022-04-13T00:00:00,37813,855,1566,4936,32484928,12589122,465828,,12123294,7256903
469,2022-04-14T00:00:00,37937,765,1629,4918,32522865,12589573,464961,,12124612,7261567
470,2022-04-15T00:00:00,43435,1238,2110,6727,32566300,12590513,464085,,12126428,7268057
471,2022-04-16T00:00:00,8117,359,653,1748,32574417,12590612,463789,,12126823,7269589
472,2022-04-17T00:00:00,21055,873,1933,4323,32595472,12591199,462722,,12128477,7273687
473,2022-04-18T00:00:00,5474,306,468,1295,32600946,12591218,462555,,12128663,7274741
474,2022-04-19T00:00:00,22682,618,781,3102,32623628,12591550,462383,,12129167,7277621
475,2022-04-20T00:00:00,40374,1065,1412,4624,32664002,12592289,462033,,12130256,7281981
476,2022-04-21T00:00:00,38784,948,1606,4686,32702786,12592941,461366,,12131575,7286433
477,2022-04-22T00:00:00,35655,1020,1443,4273,32738441,12593689,460936,,12132753,7290488
478,2022-04-23T00:00:00,34690,1008,1750,4718,32773131,12594413,460191,,12134222,7294967
479,2022-04-24T00:00:00,20854,1020,1911,3780,32793985,12595183,459297,,12135886,7298553
480,2022-04-25T00:00:00,8309,454,692,1709,32802294,12595368,459058,,12136310,7300046
481,2022-04-26T00:00:00,24658,737,958,3156,32826952,12595813,458831,,12136982,7302965
482,2022-04-27T00:00:00,33630,958,1379,3940,32860582,12596493,458402,,12138091,7306687
483,2022-04-28T00:00:00,32869,935,1425,3938,32893451,12597155,457903,,12139252,7310402
484,2022-04-29T00:00:00,32096,1097,1391,3918,32925547,12597954,457602,,12140352,7314091
485,2022-04-30T00:00:00,30319,929,1548,4028,32955866,12598585,456976,,12141609,7317883
486,2022-05-01T00:00:00,16768,772,1585,2970,32972634,12599058,456158,,12142900,7320609
487,2022-05-02T00:00:00,5945,309,528,1100,32978579,12599070,455934,,12143136,7321482
488,2022-05-03T00:00:00,20961,590,845,2349,32999540,12599355,455673,,12143682,7323592
489,2022-05-04T00:00:00,29436,802,1101,3292,33028976,12599846,455369,,12144477,7326634
490,2022-05-05T00:00:00,29121,876,1174,3128,33058097,12600408,455061,,12145347,7329516
491,2022-05-06T00:00:00,29125,1150,1291,2993,33087222,12601269,454915,,12146354,7332282
492,2022-05-07T00:00:00,28517,873,1272,3114,33115739,12601852,454511,,12147341,7335172
493,2022-05-08T00:00:00,16018,896,1312,2329,33131757,12602491,454093,,12148398,7337300
494,2022-05-09T00:00:00,5907,293,480,944,33137664,12602517,453899,,12148618,7338034
495,2022-05-10T00:00:00,21248,699,729,2120,33158912,12602897,453862,,12149035,7339893
496,2022-05-11T00:00:00,28966,838,1090,2658,33187878,12603403,453606,,12149797,7342280
497,2022-05-12T00:00:00,28264,802,1093,2522,33216142,12603908,453311,,12150597,7344561
498,2022-05-13T00:00:00,27620,882,1125,2471,33243762,12604479,453063,,12151416,7346775
499,2022-05-14T00:00:00,25714,807,1105,2613,33269476,12604974,452758,,12152216,7349134
500,2022-05-15T00:00:00,14862,752,1281,2057,33284338,12605454,452222,,12153232,7350972
501,2022-05-16T00:00:00,6391,326,534,1050,33290729,12605542,452010,,12153532,7351835
502,2022-05-17T00:00:00,19621,591,784,1744,33310350,12605817,451810,,12154007,7353330
503,2022-05-18T00:00:00,26564,876,1107,2278,33336914,12606428,451574,,12154854,7355392
504,2022-05-19T00:00:00,24463,686,1166,2163,33361377,12606847,451087,,12155760,7357338
505,2022-05-20T00:00:00,24287,804,1146,2218,33385664,12607380,450741,,12156639,7359336
506,2022-05-21T00:00:00,22426,694,1174,2354,33408090,12607764,450252,,12157512,7361447
507,2022-05-22T00:00:00,10579,551,896,1493,33418669,12608054,449902,,12158152,7362723
508,2022-05-23T00:00:00,4585,242,466,799,33423254,12608036,449676,,12158360,7363313
509,2022-05-24T00:00:00,2642,123,185,446,33425896,12607902,449612,,12158290,7363547
510,2022-05-25T00:00:00,19394,661,958,1959,33445290,12608295,449305,,12158990,7365294
511,2022-05-26T00:00:00,20671,666,955,1917,33465961,12608686,449010,,12159676,7366988
512,2022-05-27T00:00:00,21796,819,1071,2082,33487757,12609216,448755,,12160461,7368836
513,2022-05-28T00:00:00,19441,724,1173,2154,33507198,12609669,448303,,12161366,7370775
514,2022-05-29T00:00:00,12126,762,1288,1729,33519324,12610195,447770,,12162425,7372311
515,2022-05-30T00:00:00,4588,311,549,756,33523912,12610259,447528,,12162731,7372869
516,2022-05-31T00:00:00,13576,576,758,1675,33537488,12610533,447340,,12163193,7374304
517,2022-06-01T00:00:00,16648,705,983,1888,33554136,12610935,447060,,12163875,7375939
518,2022-06-02T00:00:00,14647,563,874,1685,33568783,12611186,446742,,12164444,7377383
519,2022-06-03T00:00:00,16130,702,1101,1821,33584913,12611605,446337,,12165268,7378982
520,2022-06-04T00:00:00,13340,648,1170,1850,33598253,12611995,445810,,12166185,7380630
521,2022-06-05T00:00:00,7888,587,1115,1440,33606141,12612333,445278,,12167055,7381878
522,2022-06-06T00:00:00,3301,208,446,642,33609442,12612292,445037,,12167255,7382318
523,2022-06-07T00:00:00,11253,483,735,1379,33620695,12612475,444780,,12167695,7383453
524,2022-06-08T00:00:00,14081,672,1020,1605,33634776,12612886,444427,,12168459,7384838
525,2022-06-09T00:00:00,13410,665,935,1669,33648186,12613262,444152,,12169110,7386275
526,2022-06-10T00:00:00,13879,688,1076,1700,33662065,12613662,443755,,12169907,7387745
527,2022-06-11T00:00:00,13009,623,1035,1843,33675074,12613999,443341,,12170658,7389365
528,2022-06-12T00:00:00,8110,644,1240,1504,33683184,12614384,442741,,12171643,7390662
529,2022-06-13T00:00:00,3202,286,426,718,33686386,12614402,442596,,12171806,7391170
530,2022-06-14T00:00:00,10146,516,672,1266,33696532,12614628,442434,,12172194,7392198
531,2022-06-15T00:00:00,13530,477,836,1623,33710062,12614808,442073,,12172735,7393582
532,2022-06-16T00:00:00,12568,501,863,1611,33722630,12615002,441705,,12173297,7394946
533,2022-06-17T00:00:00,11710,484,824,1648,33734340,12615197,441358,,12173839,7396356
534,2022-06-18T00:00:00,11472,438,879,1867,33745812,12615364,440914,,12174450,7397999
535,2022-06-19T00:00:00,7014,486,901,1421,33752826,12615596,440498,,12175098,7399204
536,2022-06-20T00:00:00,2289,147,301,644,33755115,12615519,440338,,12175181,7399678
537,2022-06-21T00:00:00,9570,360,622,1395,33764685,12615592,440071,,12175521,7400825
538,2022-06-22T00:00:00,13640,412,734,1706,33778325,12615732,439742,,12175990,7402306
539,2022-06-23T00:00:00,13730,409,783,1678,33792055,12615873,439365,,12176508,7403770
540,2022-06-24T00:00:00,15388,444,816,1677,33807443,12616057,438989,,12177068,7405232
541,2022-06-25T00:00:00,14510,435,860,1719,33821953,12616230,438553,,12177677,7406741
542,2022-06-26T00:00:00,8175,434,888,1287,33830128,12616402,438092,,12178310,7407811
543,2022-06-27T00:00:00,3225,173,367,597,33833353,12616324,437894,,12178430,7408200
544,2022-06-28T00:00:00,9635,375,565,1221,33842988,12616412,437700,,12178712,7409187
545,2022-06-29T00:00:00,13347,419,736,1634,33856335,12616540,437381,,12179159,7410581
546,2022-06-30T00:00:00,12261,492,852,1581,33868596,12616747,437019,,12179728,7411928
547,2022-07-01T00:00:00,13064,553,976,1946,33881660,12617041,436591,,12180450,7413667
548,2022-07-02T00:00:00,1644,118,125,372,33883304,12616883,436582,,12180301,7413807
549,2022-07-03T00:00:00,5174,259,495,966,33888478,12616883,436337,,12180546,7414556
550,2022-07-04T00:00:00,2767,133,280,616,33891245,12616769,436189,,12180580,7414975
551,2022-07-05T00:00:00,11161,373,603,1577,33902406,12616844,435951,,12180893,7416304
552,2022-07-06T00:00:00,15983,551,863,2016,33918389,12617097,435633,,12181464,7418075
553,2022-07-07T00:00:00,15695,524,837,1934,33934084,12617332,435319,,12182013,7419756
554,2022-07-08T00:00:00,17915,560,877,2247,33951999,12617586,435001,,12182585,7421753
555,2022-07-09T00:00:00,14171,457,604,1850,33966170,12617763,434853,,12182910,7423364
556,2022-07-10T00:00:00,8765,476,759,1508,33974935,12617987,434569,,12183418,7424663
557,2022-07-11T00:00:00,4103,200,335,872,33979038,12617920,434431,,12183489,7425313
558,2022-07-12T00:00:00,12139,414,534,1660,33991177,12618035,434306,,12183729,7426719
559,2022-07-13T00:00:00,16749,570,778,2147,34007926,12618307,434092,,12184215,7428621
560,2022-07-14T00:00:00,16890,486,684,2026,34024816,12618488,433883,,12184605,7430408
561,2022-07-15T00:00:00,28920,597,830,2179,34053736,12618784,433649,,12185135,7432345
562,2022-07-16T00:00:00,30330,589,777,2340,34084066,12619059,433453,,12185606,7434432
563,2022-07-17T00:00:00,22966,541,636,1904,34107032,12619361,433355,,12186006,7436140
564,2022-07-18T00:00:00,11405,190,255,857,34118437,12619282,433285,,12185997,7436774
565,2022-07-19T00:00:00,28995,596,597,2150,34147432,12619602,433281,,12186321,7438692
566,2022-07-20T00:00:00,37678,841,930,2603,34185110,12620162,433187,,12186975,7441056
567,2022-07-21T00:00:00,36416,742,820,2816,34221526,12620615,433102,,12187513,7443630
568,2022-07-22T00:00:00,35844,827,901,2691,34257370,12621152,433021,,12188131,7446083
569,2022-07-23T00:00:00,35197,822,921,2849,34292567,12621658,432914,,12188744,7448675
570,2022-07-24T00:00:00,21774,602,812,1786,34314341,12621997,432701,,12189296,7450236
571,2022-07-25T00:00:00,11946,305,310,1083,34326287,12622016,432691,,12189325,7451087
572,2022-07-26T00:00:00,26120,620,605,2223,34352407,12622350,432705,,12189645,7453065
573,2022-07-27T00:00:00,32513,811,857,2658,34384920,12622902,432657,,12190245,7455511
574,2022-07-28T00:00:00,31562,726,887,2598,34416482,12623328,432492,,12190836,7457855
575,2022-07-29T00:00:00,30029,1792,877,2650,34446511,12624826,433403,,12191423,7460253
576,2022-07-30T00:00:00,25870,2527,755,2432,34472381,12627072,435173,,12191899,7462452
577,2022-07-31T00:00:00,14341,1070,543,1579,34486722,12627870,435696,,12192174,7463801
578,2022-08-01T00:00:00,5930,339,227,684,34492652,12627948,435806,,12192142,7464261
579,2022-08-02T00:00:00,4511,309,142,614,34497163,12627986,435969,,12192017,7464652
580,2022-08-03T00:00:00,22983,2650,747,2250,34520146,12630359,437868,,12192491,7466666
581,2022-08-04T00:00:00,22280,2486,686,2145,34542426,12632516,439662,,12192854,7468546
582,2022-08-05T00:00:00,21823,2759,751,2073,34564249,12634992,441662,,12193330,7470389
583,2022-08-06T00:00:00,19679,2877,659,2000,34583928,12637555,443874,,12193681,7472128
584,2022-08-07T00:00:00,12725,2236,623,1432,34596653,12639515,445481,,12194034,7473341
585,2022-08-08T00:00:00,4772,570,188,605,34601425,12639794,445856,,12193938,7473708
586,2022-08-09T00:00:00,14046,1470,564,1610,34615471,12640974,446756,,12194218,7475076
587,2022-08-10T00:00:00,19152,2362,725,1995,34634623,12643062,448391,,12194671,7476841
588,2022-08-11T00:00:00,17108,2042,721,1868,34651731,12644827,449710,,12195117,7478475
589,2022-08-12T00:00:00,17007,2051,741,1845,34668738,12646589,451019,,12195570,7480091
590,2022-08-13T00:00:00,15976,2227,774,1814,34684714,12648529,452470,,12196059,7481662
591,2022-08-14T00:00:00,9543,1622,621,1091,34694257,12649860,453467,,12196393,7482516
592,2022-08-15T00:00:00,3877,387,269,484,34698134,12649990,453582,,12196408,7482790
593,2022-08-16T00:00:00,10824,1076,518,1360,34708958,12650763,454138,,12196625,7483897
594,2022-08-17T00:00:00,16135,1839,741,1792,34725093,12652311,455234,,12197077,7485451
595,2022-08-18T00:00:00,14953,1644,750,1700,34740046,12653629,456124,,12197505,7486878
596,2022-08-19T00:00:00,15341,1848,754,1561,34755387,12655198,457214,,12197984,7488205
597,2022-08-20T00:00:00,14301,1643,744,1553,34769688,12656547,458107,,12198440,7489517
598,2022-08-21T00:00:00,9919,1532,665,1172,34779607,12657812,458970,,12198842,7490471
599,2022-08-22T00:00:00,4175,480,274,563,34783782,12657986,459173,,12198813,7490773
600,2022-08-23T00:00:00,11172,1252,559,1512,34794954,12658928,459862,,12199066,7492031
601,2022-08-24T00:00:00,14782,1810,874,2198,34809736,12660466,460798,,12199668,7493997
602,2022-08-25T00:00:00,14047,1720,783,2127,34823783,12661896,461728,,12200168,7495877
603,2022-08-26T00:00:00,13948,1689,819,2095,34837731,12663286,462591,,12200695,7497721
604,2022-08-27T00:00:00,12443,1489,879,2010,34850174,12664447,463195,,12201252,7499464
605,2022-08-28T00:00:00,7942,1260,624,1404,34858116,12665445,463829,,12201616,7500647
606,2022-08-29T00:00:00,3407,503,285,685,34861523,12665665,464042,,12201623,7501096
607,2022-08-30T00:00:00,9920,1168,654,1857,34871443,12666474,464550,,12201924,7502649
608,2022-08-31T00:00:00,13528,1628,947,2316,34884971,12667807,465227,,12202580,7504719
609,2022-09-01T00:00:00,12926,1723,916,2145,34897897,12669234,466029,,12203205,7506618
610,2022-09-02T00:00:00,15057,1616,995,4918,34912954,12670572,466642,,12203930,7511307
611,2022-09-03T00:00:00,14730,1528,927,5519,34927684,12671812,467240,,12204572,7516588
612,2022-09-04T00:00:00,8682,1010,679,3245,34936366,12672555,467561,,12204994,7519611
613,2022-09-05T00:00:00,3562,321,229,1389,34939928,12672607,467650,,12204957,7520775
614,2022-09-06T00:00:00,2484,159,119,1138,34942412,12672509,467687,,12204822,7521703
615,2022-09-07T00:00:00,10946,1022,593,3494,34953358,12673229,468112,,12205117,7524942
616,2022-09-08T00:00:00,10888,1023,530,2794,34964246,12673921,468602,,12205319,7527457
617,2022-09-09T00:00:00,9600,1014,492,2506,34973846,12674646,469119,,12205527,7529726
618,2022-09-10T00:00:00,10670,1272,555,3168,34984516,12675638,469829,,12205809,7532658
619,2022-09-11T00:00:00,9435,979,671,3742,34993951,12676366,470131,,12206235,7536189
620,2022-09-12T00:00:00,3133,295,205,1080,34997084,12676376,470214,,12206162,7537031
621,2022-09-13T00:00:00,6040,546,292,1137,35003124,12676632,470459,,12206173,7537922
622,2022-09-14T00:00:00,14497,797,436,1849,35017621,12677108,470816,,12206292,7539503
623,2022-09-15T00:00:00,15778,782,415,1540,35033399,12677569,471178,,12206391,7540771
624,2022-09-16T00:00:00,17772,769,450,1696,35051171,12678074,471491,,12206583,7542242
625,2022-09-17T00:00:00,17642,725,461,1672,35068813,12678490,471751,,12206739,7543656
626,2022-09-18T00:00:00,11229,773,451,1691,35080042,12678999,472071,,12206928,7545121
627,2022-09-19T00:00:00,4988,405,287,670,35085030,12679129,472184,,12206945,7545575
628,2022-09-20T00:00:00,13800,448,334,942,35098830,12679261,472296,,12206965,7546253
629,2022-09-21T00:00:00,23068,651,413,1498,35121898,12679600,472529,,12207071,7547494
630,2022-09-22T00:00:00,22940,637,404,1390,35144838,12679925,472756,,12207169,7548620
631,2022-09-23T00:00:00,22984,726,605,1418,35167822,12680343,472872,,12207471,7549776
632,2022-09-24T00:00:00,21716,739,692,1503,35189538,12680787,472915,,12207872,7551042
633,2022-09-25T00:00:00,11338,595,700,1361,35200876,12681098,472804,,12208294,7552164
634,2022-09-26T00:00:00,4572,191,222,595,35205448,12680996,472767,,12208229,7552513
635,2022-09-27T00:00:00,37676,496,372,1492,35243124,12681221,472887,,12208334,7553777
636,2022-09-28T00:00:00,50992,730,673,1903,35294116,12681681,472943,,12208738,7555453
637,2022-09-29T00:00:00,48054,639,752,1833,35342170,12681994,472822,,12209172,7557006
638,2022-09-30T00:00:00,47300,676,814,1999,35389470,12682342,472682,,12209660,7558723
639,2022-10-01T00:00:00,34466,524,636,1550,35423936,12682556,472568,,12209988,7560005
640,2022-10-02T00:00:00,24270,737,1033,1710,35448206,12682994,472269,,12210725,7561460
641,2022-10-03T00:00:00,10882,237,235,612,35459088,12682938,472267,,12210671,7561833
642,2022-10-04T00:00:00,32216,476,463,1161,35491304,12683091,472276,,12210815,7562714
643,2022-10-05T00:00:00,40461,633,743,1556,35531765,12683399,472159,,12211240,7564002
644,2022-10-06T00:00:00,38722,610,656,1566,35570487,12683702,472111,,12211591,7565305
645,2022-10-07T00:00:00,42282,665,860,1741,35612769,12684019,471908,,12212111,7566744
646,2022-10-08T00:00:00,37424,782,1146,2124,35650193,12684467,471538,,12212929,7568591
647,2022-10-09T00:00:00,18828,548,729,1554,35669021,12684733,471354,,12213379,7569903
648,2022-10-10T00:00:00,6878,163,373,569,35675899,12684596,471141,,12213455,7570210
649,2022-10-11T00:00:00,5014,128,116,319,35680913,12684428,471148,,12213280,7570290
650,2022-10-12T00:00:00,35135,580,687,1427,35716048,12684672,471039,,12213633,7571425
651,2022-10-13T00:00:00,36788,647,863,1618,35752836,12684946,470819,,12214127,7572729
652,2022-10-14T00:00:00,37008,623,758,1535,35789844,12685231,470680,,12214551,7573980
653,2022-10-15T00:00:00,35485,717,1018,1629,35825329,12685653,470376,,12215277,7575358
654,2022-10-16T00:00:00,20679,654,1028,1591,35846008,12686033,469996,,12216037,7576715
655,2022-10-17T00:00:00,7363,206,477,543,35853371,12685949,469723,,12216226,7577014
656,2022-10-18T00:00:00,36468,455,508,1396,35889839,12686079,469665,,12216414,7578135
657,2022-10-19T00:00:00,49929,617,731,1975,35939768,12686391,469547,,12216844,7579857
658,2022-10-20T00:00:00,51322,619,653,2049,35991090,12686692,469510,,12217182,7581638
659,2022-10-21T00:00:00,52870,697,622,1927,36043960,12687057,469579,,12217478,7583293
660,2022-10-22T00:00:00,50901,751,908,2314,36094861,12687472,469417,,12218055,7585327
661,2022-10-23T00:00:00,30665,570,786,2124,36125526,12687722,469194,,12218528,7587185
662,2022-10-24T00:00:00,14135,232,272,976,36139661,12687647,469149,,12218498,7587899
663,2022-10-25T00:00:00,41389,471,488,1818,36181050,12687762,469129,,12218633,7589415
664,2022-10-26T00:00:00,51677,612,660,2117,36232727,12688035,469077,,12218958,7591249
665,2022-10-27T00:00:00,50148,604,770,2160,36282875,12688310,468903,,12219407,7593135
666,2022-10-28T00:00:00,49826,587,679,2091,36332701,12688531,468806,,12219725,7594913
667,2022-10-29T00:00:00,50642,734,782,2222,36383343,12688910,468754,,12220156,7596829
668,2022-10-30T00:00:00,28422,659,931,2039,36411765,12689279,468478,,12220801,7598620
669,2022-10-31T00:00:00,12451,200,235,778,36424216,12689191,468439,,12220752,7599157
670,2022-11-01T00:00:00,33120,339,199,1221,36457336,12689181,468573,,12220608,7600085
671,2022-11-02T00:00:00,44315,570,627,1906,36501651,12689410,468512,,12220898,7601684
672,2022-11-03T00:00:00,44224,539,607,1860,36545875,12689613,468439,,12221174,7603254
673,2022-11-04T00:00:00,44671,648,530,2027,36590546,12689950,468550,,12221400,7605022
674,2022-11-05T00:00:00,45235,646,760,2368,36635781,12690288,468433,,12221855,7607118
675,2022-11-06T00:00:00,26035,558,774,2100,36661816,12690498,468214,,12222284,7608916
676,2022-11-07T00:00:00,10723,242,235,877,36672539,12690444,468218,,12222226,7609548
677,2022-11-08T00:00:00,33517,488,399,1586,36706056,12690636,468304,,12222332,7610885
678,2022-11-09T00:00:00,40569,605,573,1969,36746625,12690913,468334,,12222579,7612575
679,2022-11-10T00:00:00,39219,619,553,1929,36785844,12691207,468394,,12222813,7614225
680,2022-11-11T00:00:00,43375,639,647,2209,36829219,12691519,468384,,12223135,7616153
681,2022-11-12T00:00:00,36877,636,596,2189,36866096,12691828,468416,,12223412,7618057
682,2022-11-13T00:00:00,24288,557,773,2279,36890384,12692081,468194,,12223887,7620075
683,2022-11-14T00:00:00,10980,231,205,1026,36901364,12692012,468219,,12223793,7620839
684,2022-11-15T00:00:00,33668,487,383,1696,36935032,12692127,468317,,12223810,7622220
685,2022-11-16T00:00:00,43555,800,587,2369,36978587,12692621,468524,,12224097,7624332
686,2022-11-17T00:00:00,38375,676,650,2245,37016962,12692952,468546,,12224406,7626283
687,2022-11-18T00:00:00,40662,722,533,2338,37057624,12693320,468731,,12224589,7628316
688,2022-11-19T00:00:00,39688,1006,1033,3063,37097312,12693972,468697,,12225275,7631068
689,2022-11-20T00:00:00,22452,659,721,2446,37119764,12694344,468631,,12225713,7633277
690,2022-11-21T00:00:00,8932,196,194,967,37128696,12694269,468628,,12225641,7634031
691,2022-11-22T00:00:00,26461,482,373,1515,37155157,12694382,468732,,12225650,7635224
692,2022-11-23T00:00:00,32115,686,667,2073,37187272,12694725,468748,,12225977,7637007
693,2022-11-24T00:00:00,31955,665,757,2087,37219227,12695068,468653,,12226415,7638826
694,2022-11-25T00:00:00,30770,761,829,1959,37249997,12695508,468579,,12226929,7640514
695,2022-11-26T00:00:00,30320,906,1198,2699,37280317,12696064,468278,,12227786,7642914
696,2022-11-27T00:00:00,18693,608,946,2090,37299010,12696353,467934,,12228419,7644735
697,2022-11-28T00:00:00,7555,191,283,787,37306565,12696233,467834,,12228399,7645251
698,2022-11-29T00:00:00,21051,420,454,1293,37327616,12696311,467796,,12228515,7646256
699,2022-11-30T00:00:00,27914,641,649,1844,37355530,12696622,467786,,12228836,7647814
700,2022-12-01T00:00:00,24840,602,687,1696,37380370,12696887,467697,,12229190,7649217
701,2022-12-02T00:00:00,25073,522,632,1776,37405443,12697066,467580,,12229486,7650700
702,2022-12-03T00:00:00,25581,588,782,1947,37431024,12697320,467376,,12229944,7652373
703,2022-12-04T00:00:00,15264,494,609,1707,37446288,12697470,467255,,12230215,7653779
704,2022-12-05T00:00:00,6881,167,158,746,37453169,12697334,467258,,12230076,7654270
705,2022-12-06T00:00:00,20372,421,353,1381,37473541,12697373,467320,,12230053,7655329
706,2022-12-07T00:00:00,24819,554,616,1679,37498360,12697598,467250,,12230348,7656728
707,2022-12-08T00:00:00,23177,565,522,1768,37521537,12697832,467291,,12230541,7658206
708,2022-12-09T00:00:00,23350,637,577,1633,37544887,12698125,467346,,12230779,7659554
709,2022-12-10T00:00:00,22601,510,607,1631,37567488,12698305,467246,,12231059,7660898
710,2022-12-11T00:00:00,14216,546,787,1569,37581704,12698572,467002,,12231570,7662231
711,2022-12-12T00:00:00,5514,149,157,595,37587218,12698419,466989,,12231430,7662579
712,2022-12-13T00:00:00,17827,376,373,1128,37605045,12698460,466990,,12231470,7663422
713,2022-12-14T00:00:00,21346,512,550,1456,37626391,12698664,466946,,12231718,7664624
714,2022-12-15T00:00:00,21998,535,611,1578,37648389,12698843,466868,,12231975,7665896
715,2022-12-16T00:00:00,16305,381,453,1030,37664694,12698893,466793,,12232100,7666646
716,2022-12-17T00:00:00,18729,556,512,1284,37683423,12699112,466835,,12232277,7667634
717,2022-12-18T00:00:00,12651,531,796,1308,37696074,12699351,466569,,12232782,7668681
718,2022-12-19T00:00:00,4593,131,117,451,37700667,12699137,466579,,12232558,7668838
719,2022-12-20T00:00:00,16231,496,452,1111,37716898,12699304,466615,,12232689,7669677
720,2022-12-21T00:00:00,18497,541,556,1304,37735395,12699530,466596,,12232934,7670707
721,2022-12-22T00:00:00,18644,573,592,1749,37754039,12699792,466577,,12233215,7672185
722,2022-12-23T00:00:00,15674,577,606,1721,37769713,12700000,466543,,12233457,7673600
723,2022-12-24T00:00:00,5351,225,174,676,37775064,12699897,466593,,12233304,7673982
724,2022-12-25T00:00:00,2452,153,155,480,37777516,12699731,466581,,12233150,7674188
725,2022-12-26T00:00:00,263,12,8,48,37777779,12699427,466580,,12232847,7673971
726,2022-12-27T00:00:00,2105,98,37,307,37779884,12699228,466637,,12232591,7674034
727,2022-12-28T00:00:00,8340,339,175,979,37788224,12699239,466796,,12232443,7674730
728,2022-12-29T00:00:00,13183,584,530,1600,37801407,12699471,466845,,12232626,7676027
729,2022-12-30T00:00:00,15842,664,661,1882,37817249,12699813,466845,,12232968,7677624
730,2022-12-31T00:00:00,11249,460,392,1356,37828498,12699903,466909,,12232994,7678663
731,2023-01-01T00:00:00,3915,201,219,563,37832413,12699774,466889,,12232885,7678937
732,2023-01-02T00:00:00,654,37,13,98,37833067,12699503,466912,,12232591,7678770
733,2023-01-03T00:00:00,8204,296,152,901,37841271,12699490,467050,,12232440,7679411
734,2023-01-04T00:00:00,14744,576,549,1548,37856015,12699759,467070,,12232689,7680691
735,2023-01-05T00:00:00,16139,643,537,1798,37872154,12700077,467167,,12232910,7682207
736,2023-01-06T00:00:00,18858,713,616,2046,37891012,12700472,467261,,12233211,7683977
737,2023-01-07T00:00:00,18551,705,644,2064,37909563,12700876,467317,,12233559,7685778
738,2023-01-08T00:00:00,11629,579,608,1638,37921192,12701183,467284,,12233899,7687180
739,2023-01-09T00:00:00,5308,217,197,665,37926500,12701075,467301,,12233774,7687570
740,2023-01-10T00:00:00,12176,413,318,789,37938676,12701163,467394,,12233769,7688076
741,2023-01-11T00:00:00,15579,461,373,1103,37954255,12701279,467476,,12233803,7688889
742,2023-01-12T00:00:00,14103,445,409,976,37968358,12701395,467511,,12233884,7689588
743,2023-01-13T00:00:00,14204,419,348,1041,37982562,12701534,467579,,12233955,7690385
744,2023-01-14T00:00:00,13416,471,452,1080,37995978,12701676,467592,,12234084,7691180
745,2023-01-15T00:00:00,9057,459,508,1058,38005035,12701831,467542,,12234289,7691983
746,2023-01-16T00:00:00,3753,145,133,479,38008788,12701679,467554,,12234125,7692202
747,2023-01-17T00:00:00,8867,265,182,657,38017655,12701589,467633,,12233956,7692559
748,2023-01-18T00:00:00,10291,349,275,767,38027946,12701619,467703,,12233916,7693044
749,2023-01-19T00:00:00,10607,313,321,763,38038553,12701619,467690,,12233929,7693544
750,2023-01-20T00:00:00,9862,327,277,719,38048415,12701641,467738,,12233903,7693996
751,2023-01-21T00:00:00,11334,354,408,910,38059749,12701671,467683,,12233988,7694633
752,2023-01-22T00:00:00,7581,341,406,823,38067330,12701727,467613,,12234114,7695207
753,2023-01-23T00:00:00,3386,143,132,290,38070716,12701610,467623,,12233987,7695268
754,2023-01-24T00:00:00,8309,229,168,556,38079025,12701498,467681,,12233817,7695528
755,2023-01-25T00:00:00,10330,347,301,667,38089355,12701555,467723,,12233832,7695950
756,2023-01-26T00:00:00,6741,237,207,469,38096096,12701478,467749,,12233729,7696157
757,2023-01-27T00:00:00,6938,242,200,500,38103034,12701389,467788,,12233601,7696376
758,2023-01-28T00:00:00,9383,314,339,702,38112417,12701393,467757,,12233636,7696815
759,2023-01-29T00:00:00,5994,235,345,699,38118411,12701323,467642,,12233681,7697247
760,2023-01-30T00:00:00,1906,88,83,214,38120317,12701104,467645,,12233459,7697194
761,2023-01-31T00:00:00,5899,157,153,415,38126216,12700931,467644,,12233287,7697319
762,2023-02-01T00:00:00,7321,250,251,497,38133537,12700906,467640,,12233266,7697584
763,2023-02-02T00:00:00,6501,294,242,506,38140038,12700908,467688,,12233220,7697853
764,2023-02-03T00:00:00,6574,198,198,467,38146612,12700815,467683,,12233132,7698068
765,2023-02-04T00:00:00,6752,233,312,549,38153364,12700761,467597,,12233164,7698374
766,2023-02-05T00:00:00,4181,199,291,486,38157545,12700659,467500,,12233159,7698610
767,2023-02-06T00:00:00,1837,90,98,212,38159382,12700436,467489,,12232947,7698546
768,2023-02-07T00:00:00,4976,160,183,385,38164358,12700263,467462,,12232801,7698655
769,2023-02-08T00:00:00,5783,213,207,430,38170141,12700167,467462,,12232705,7698819
770,2023-02-09T00:00:00,6141,213,246,440,38176282,12700077,467428,,12232649,7699002
771,2023-02-10T00:00:00,5119,160,211,382,38181401,12699980,467372,,12232608,7699166
772,2023-02-11T00:00:00,6074,184,264,461,38187475,12699859,467287,,12232572,7699353
773,2023-02-12T00:00:00,4093,221,344,410,38191568,12699807,467160,,12232647,7699522
774,2023-02-13T00:00:00,1486,57,87,146,38193054,12699592,467128,,12232464,7699439
775,2023-02-14T00:00:00,3973,134,181,313,38197027,12699417,467079,,12232338,7699477
776,2023-02-15T00:00:00,4564,119,190,285,38201591,12699249,467005,,12232244,7699519
777,2023-02-16T00:00:00,4929,173,285,402,38206520,12699113,466888,,12232225,7699656
778,2023-02-17T00:00:00,5007,182,215,345,38211527,12699020,466851,,12232169,7699770
779,2023-02-18T00:00:00,5139,234,295,487,38216666,12698969,466788,,12232181,7700013
780,2023-02-19T00:00:00,3358,132,244,374,38220024,12698818,466671,,12232147,7700151
781,2023-02-20T00:00:00,1426,62,55,159,38221450,12698607,466675,,12231932,7700078
782,2023-02-21T00:00:00,919,27,15,108,38222369,12698364,466681,,12231683,7699951
783,2023-02-22T00:00:00,4151,132,213,371,38226520,12698205,466593,,12231612,7700086
784,2023-02-23T00:00:00,4302,165,231,394,38230822,12698074,466520,,12231554,7700229
785,2023-02-24T00:00:00,3042,136,233,275,38233864,12697924,466418,,12231506,7700248
786,2023-02-25T00:00:00,5038,214,544,386,38238902,12697858,466086,,12231772,7700399
787,2023-02-26T00:00:00,3487,148,683,387,38242389,12697711,465547,,12232164,7700540
788,2023-02-27T00:00:00,1080,37,56,97,38243469,12697484,465522,,12231962,7700419
789,2023-02-28T00:00:00,2745,100,164,237,38246214,12697275,465456,,12231819,7700381
790,2023-03-01T00:00:00,3875,138,429,346,38250089,12697081,465158,,12231923,7700433
791,2023-03-02T00:00:00,4614,159,495,331,38254703,12696897,464811,,12232086,7700482
792,2023-03-03T00:00:00,4389,159,358,340,38259092,12696754,464609,,12232145,7700556
793,2023-03-04T00:00:00,4984,208,624,351,38264076,12696652,464190,,12232462,7700641
794,2023-03-05T00:00:00,2550,113,451,256,38266626,12696439,463850,,12232589,7700615
795,2023-03-06T00:00:00,1163,48,38,114,38267789,12696200,463856,,12232344,7700482
796,2023-03-07T00:00:00,3246,88,175,230,38271035,12695940,463764,,12232176,7700420
797,2023-03-08T00:00:00,4344,134,412,292,38275379,12695747,463484,,12232263,7700424
798,2023-03-09T00:00:00,4644,174,454,315,38280023,12695609,463198,,12232411,7700472
799,2023-03-10T00:00:00,3967,99,139,259,38283990,12695431,463154,,12232277,7700499
800,2023-03-11T00:00:00,4086,143,174,288,38288076,12695314,463119,,12232195,7700558
801,2023-03-12T00:00:00,2929,111,238,305,38291005,12695123,462981,,12232142,7700609
802,2023-03-13T00:00:00,865,29,32,106,38291870,12694887,462972,,12231915,7700484
803,2023-03-14T00:00:00,3102,98,111,263,38294972,12694684,462959,,12231725,7700490
804,2023-03-15T00:00:00,4124,136,163,315,38299096,12694538,462929,,12231609,7700558
805,2023-03-16T00:00:00,4060,178,234,282,38303156,12694363,462864,,12231499,7700552
806,2023-03-17T00:00:00,4321,171,209,315,38307477,12694209,462822,,12231387,7700581
807,2023-03-18T00:00:00,4393,144,194,300,38311870,12694048,462771,,12231277,7700614
808,2023-03-19T00:00:00,2729,129,233,260,38314599,12693921,462663,,12231258,7700647
809,2023-03-20T00:00:00,781,34,19,74,38315380,12693659,462675,,12230984,7700471
810,2023-03-21T00:00:00,2916,69,86,201,38318296,12693435,462652,,12230783,7700426
811,2023-03-22T00:00:00,3920,131,136,250,38322216,12693259,462644,,12230615,7700403
812,2023-03-23T00:00:00,3845,115,174,233,38326061,12693058,462579,,12230479,7700368
813,2023-03-24T00:00:00,3733,102,116,240,38329794,12692878,462563,,12230315,7700374
814,2023-03-25T00:00:00,4325,107,176,255,38334119,12692691,462487,,12230204,7700377
815,2023-03-26T00:00:00,2518,113,219,203,38336637,12692513,462375,,12230138,7700335
816,2023-03-27T00:00:00,922,49,32,69,38337559,12692312,462390,,12229922,7700185
817,2023-03-28T00:00:00,3123,88,82,206,38340682,12692088,462387,,12229701,7700130
818,2023-03-29T00:00:00,4219,126,141,227,38344901,12691915,462366,,12229549,7700102
819,2023-03-30T00:00:00,3881,108,164,218,38348782,12691725,462308,,12229417,7700052
820,2023-03-31T00:00:00,4022,139,111,225,38352804,12691558,462335,,12229223,7700023
821,2023-04-01T00:00:00,4248,134,151,231,38357052,12691389,462315,,12229074,7700001
822,2023-04-02T00:00:00,2202,62,126,175,38359254,12691131,462247,,12228884,7699902
823,2023-04-03T00:00:00,785,24,12,54,38360039,12690876,462255,,12228621,7699713
824,2023-04-04T00:00:00,3453,77,78,172,38363492,12690670,462252,,12228418,7699632
825,2023-04-05T00:00:00,4419,98,113,253,38367911,12690449,462232,,12228217,7699615
826,2023-04-06T00:00:00,3738,110,110,194,38371649,12690271,462228,,12228043,7699561
827,2023-04-07T00:00:00,4636,104,118,250,38376285,12690068,462210,,12227858,7699551
828,2023-04-08T00:00:00,846,23,14,55,38377131,12689823,462213,,12227610,7699381
829,2023-04-09T00:00:00,2461,81,104,166,38379592,12689657,462187,,12227470,7699338
830,2023-04-10T00:00:00,364,9,6,21,38379956,12689381,462184,,12227197,7699128
831,2023-04-11T00:00:00,2797,34,30,126,38382753,12689108,462186,,12226922,7698983
832,2023-04-12T00:00:00,6392,107,97,193,38389145,12688921,462189,,12226732,7698937
833,2023-04-13T00:00:00,7049,106,130,213,38396194,12688725,462157,,12226568,7698888
834,2023-04-14T00:00:00,6553,90,106,210,38402747,12688529,462133,,12226396,7698866
835,2023-04-15T00:00:00,6997,107,151,239,38409744,12688347,462084,,12226263,7698865
836,2023-04-16T00:00:00,3299,83,145,174,38413043,12688127,462018,,12226109,7698779
837,2023-04-17T00:00:00,865,12,13,49,38413908,12687879,462013,,12225866,7698615
838,2023-04-18T00:00:00,4822,99,78,164,38418730,12687672,462030,,12225642,7698516
839,2023-04-19T00:00:00,6604,118,102,182,38425334,12687475,462044,,12225431,7698424
840,2023-04-20T00:00:00,6426,103,155,213,38431760,12687301,461989,,12225312,7698401
841,2023-04-21T00:00:00,5807,86,78,135,38437567,12687096,461993,,12225103,7698288
842,2023-04-22T00:00:00,6439,95,92,181,38444006,12686905,461993,,12224912,7698230
843,2023-04-23T00:00:00,3319,119,147,172,38447325,12686763,461964,,12224799,7698174
844,2023-04-24T00:00:00,963,4,13,59,38448288,12686494,461952,,12224542,7698013
845,2023-04-25T00:00:00,4842,69,70,188,38453130,12686275,461951,,12224324,7697946
846,2023-04-26T00:00:00,6640,110,94,210,38459770,12686120,461966,,12224154,7697924
847,2023-04-27T00:00:00,6936,118,153,211,38466706,12685942,461925,,12224017,7697884
848,2023-04-28T00:00:00,6698,86,86,189,38473404,12685745,461921,,12223824,7697824
849,2023-04-29T00:00:00,6586,123,114,204,38479990,12685574,461926,,12223648,7697777
850,2023-04-30T00:00:00,2663,95,128,148,38482653,12685415,461892,,12223523,7697704
851,2023-05-01T00:00:00,1032,20,18,31,38483685,12685142,461885,,12223257,7697488
852,2023-05-02T00:00:00,4384,67,59,110,38488069,12684907,461887,,12223020,7697341
853,2023-05-03T00:00:00,5677,108,107,180,38493746,12684727,461881,,12222846,7697278
854,2023-05-04T00:00:00,8152,85,86,140,38501898,12684512,461877,,12222635,7697174
855,2023-05-05T00:00:00,13131,91,99,170,38515029,12684323,461864,,12222459,7697102
856,2023-05-06T00:00:00,15738,109,98,160,38530767,12684177,461873,,12222304,7697035
857,2023-05-07T00:00:00,6115,56,96,109,38536882,12683978,461826,,12222152,7696926
858,2023-05-08T00:00:00,2180,17,5,37,38539062,12683728,461833,,12221895,7696738
859,2023-05-09T00:00:00,12649,58,51,130,38551711,12683502,461833,,12221669,7696631
860,2023-05-10T00:00:00,14856,71,80,158,38566567,12683296,461819,,12221477,7696555
861,2023-05-11T00:00:00,13433,79,78,161,38580000,12683121,461819,,12221302,7696491
862,2023-05-12T00:00:00,13599,83,80,180,38593599,12682925,461817,,12221108,7696432
863,2023-05-13T00:00:00,11505,80,78,149,38605104,12682675,461814,,12220861,7696295
864,2023-05-14T00:00:00,4209,67,96,103,38609313,12682478,461781,,12220697,7696187
865,2023-05-15T00:00:00,1056,9,6,38,38610369,12682235,461778,,12220457,7696013
866,2023-05-16T00:00:00,8988,57,49,95,38619357,12682004,461779,,12220225,7695866
867,2023-05-17T00:00:00,11195,97,83,142,38630552,12681812,461787,,12220025,7695746
868,2023-05-18T00:00:00,10953,79,70,154,38641505,12681598,461794,,12219804,7695649
869,2023-05-19T00:00:00,10565,95,98,160,38652070,12681400,461785,,12219615,7695549
870,2023-05-20T00:00:00,9462,90,90,172,38661532,12681171,461780,,12219391,7695441
871,2023-05-21T00:00:00,3105,47,86,95,38664637,12680968,461739,,12219229,7695318
872,2023-05-22T00:00:00,975,14,12,30,38665612,12680703,461739,,12218964,7695105
873,2023-05-23T00:00:00,758,8,3,18,38666370,12680447,461740,,12218707,7694902
874,2023-05-24T00:00:00,8190,56,82,111,38674560,12680212,461713,,12218499,7694754
875,2023-05-25T00:00:00,9409,76,93,165,38683969,12679987,461690,,12218297,7694657
876,2023-05-26T00:00:00,8059,70,73,125,38692028,12679794,461684,,12218110,7694553
877,2023-05-27T00:00:00,8315,110,78,133,38700343,12679613,461713,,12217900,7694442
878,2023-05-28T00:00:00,2928,56,73,105,38703271,12679411,461691,,12217720,7694327
879,2023-05-29T00:00:00,978,13,11,30,38704249,12679158,461689,,12217469,7694122
880,2023-05-30T00:00:00,6119,57,51,115,38710368,12678909,461692,,12217217,7693971
881,2023-05-31T00:00:00,8210,93,95,122,38718578,12678697,461685,,12217012,7693843
882,2023-06-01T00:00:00,7482,70,93,126,38726060,12678485,461659,,12216826,7693726
883,2023-06-02T00:00:00,6406,55,53,125,38732466,12678238,461658,,12216580,7693588
884,2023-06-03T00:00:00,5546,72,64,126,38738012,12678005,461665,,12216340,7693458
885,2023-06-04T00:00:00,2074,47,78,79,38740086,12677782,461626,,12216156,7693305
886,2023-06-05T00:00:00,606,11,7,19,38740692,12677524,461627,,12215897,7693096
887,2023-06-06T00:00:00,4510,38,39,79,38745202,12677256,461622,,12215634,7692914
888,2023-06-07T00:00:00,5888,64,67,120,38751090,12677056,461614,,12215442,7692814
889,2023-06-08T00:00:00,5823,58,69,114,38756913,12676870,461599,,12215271,7692718
890,2023-06-09T00:00:00,6264,79,83,121,38763177,12676663,461590,,12215073,7692593
891,2023-06-10T00:00:00,5411,76,95,120,38768588,12676441,461565,,12214876,7692458
892,2023-06-11T00:00:00,2017,54,62,107,38770605,12676252,461551,,12214701,7692360
893,2023-06-12T00:00:00,697,11,7,38,38771302,12676015,461550,,12214465,7692186
894,2023-06-13T00:00:00,4273,56,59,104,38775575,12675787,461544,,12214243,7692053
895,2023-06-14T00:00:00,5512,74,85,120,38781087,12675574,461531,,12214043,7691932
896,2023-06-15T00:00:00,5173,74,75,124,38786260,12675347,461525,,12213822,7691799
897,2023-06-16T00:00:00,5855,71,65,121,38792115,12675131,461526,,12213605,7691675
898,2023-06-17T00:00:00,4202,63,62,115,38796317,12674906,461525,,12213381,7691549
899,2023-06-18T00:00:00,1574,41,61,99,38797891,12674666,461501,,12213165,7691413
900,2023-06-19T00:00:00,376,6,2,16,38798267,12674404,461501,,12212903,7691204
901,2023-06-20T00:00:00,3285,53,43,93,38801552,12674155,461507,,12212648,7691038
902,2023-06-21T00:00:00,3769,43,57,96,38805321,12673936,461486,,12212450,7690902
903,2023-06-22T00:00:00,4030,74,72,122,38809351,12673741,461483,,12212258,7690791
904,2023-06-23T00:00:00,4564,54,46,94,38813915,12673541,461485,,12212056,7690670
905,2023-06-24T00:00:00,3768,52,64,74,38817683,12673304,461470,,12211834,7690499
906,2023-06-25T00:00:00,1555,31,53,97,38819238,12673059,461444,,12211615,7690365
907,2023-06-26T00:00:00,521,11,10,25,38819759,12672826,461442,,12211384,7690174
908,2023-06-27T00:00:00,3166,79,46,94,38822925,12672612,461472,,12211140,7690022
909,2023-06-28T00:00:00,4160,70,60,92,38827085,12672407,461479,,12210928,7689869
910,2023-06-29T00:00:00,4088,62,72,90,38831173,12672219,461463,,12210756,7689747
911,2023-06-30T00:00:00,3917,75,61,131,38835090,12672028,461472,,12210556,7689651
912,2023-07-01T00:00:00,3301,53,89,124,38838391,12671793,461433,,12210360,7689530
913,2023-07-02T00:00:00,276,9,4,18,38838667,12671526,461435,,12210091,7689314
914,2023-07-03T00:00:00,388,7,5,27,38839055,12671290,461436,,12209854,7689141
915,2023-07-04T00:00:00,1269,18,14,50,38840324,12671048,461438,,12209610,7688965
916,2023-07-05T00:00:00,2454,58,42,73,38842778,12670842,461450,,12209392,7688817
917,2023-07-06T00:00:00,2589,38,70,89,38845367,12670579,461415,,12209164,7688649
918,2023-07-07T00:00:00,2869,53,46,76,38848236,12670394,461416,,12208978,7688525
919,2023-07-08T00:00:00,2493,66,44,95,38850729,12670182,461434,,12208748,7688380
920,2023-07-09T00:00:00,937,31,45,38,38851666,12669968,461419,,12208549,7688201
921,2023-07-10T00:00:00,296,5,3,15,38851962,12669692,461418,,12208274,7687975
922,2023-07-11T00:00:00,1841,35,20,65,38853803,12669471,461427,,12208044,7687827
923,2023-07-12T00:00:00,2391,51,54,89,38856194,12669278,461423,,12207855,7687701
924,2023-07-13T00:00:00,2345,54,69,68,38858539,12669060,461402,,12207658,7687539
925,2023-07-14T00:00:00,2080,64,50,62,38860619,12668869,461413,,12207456,7687382
926,2023-07-15T00:00:00,1996,51,56,78,38862615,12668667,461405,,12207262,7687245
927,2023-07-16T00:00:00,840,36,31,44,38863455,12668437,461407,,12207030,7687067
928,2023-07-17T00:00:00,200,5,1,11,38863655,12668205,461403,,12206802,7686882
929,2023-07-18T00:00:00,1347,44,47,56,38865002,12667962,461397,,12206565,7686699
930,2023-07-19T00:00:00,1912,53,56,59,38866914,12667753,461389,,12206364,7686538
931,2023-07-20T00:00:00,1719,76,57,64,38868633,12667574,461405,,12206169,7686383
932,2023-07-21T00:00:00,1777,54,40,52,38870410,12667363,461414,,12205949,7686209
933,2023-07-22T00:00:00,1565,40,63,78,38871975,12667149,461391,,12205758,7686052
934,2023-07-23T00:00:00,717,29,31,51,38872692,12666937,461386,,12205551,7685890
935,2023-07-24T00:00:00,239,11,2,15,38872931,12666697,461393,,12205304,7685686
936,2023-07-25T00:00:00,1120,49,27,50,38874051,12666461,461412,,12205049,7685482
937,2023-07-26T00:00:00,1395,47,51,43,38875446,12666262,461406,,12204856,7685309
938,2023-07-27T00:00:00,1323,66,48,55,38876769,12666058,461419,,12204639,7685136
939,2023-07-28T00:00:00,1491,47,47,59,38878260,12665843,461418,,12204425,7684962
940,2023-07-29T00:00:00,1357,51,49,72,38879617,12665625,461415,,12204210,7684800
941,2023-07-30T00:00:00,665,31,19,30,38880282,12665396,461423,,12203973,7684614
942,2023-07-31T00:00:00,232,6,4,17,38880514,12665167,461420,,12203747,7684429
943,2023-08-01T00:00:00,1155,46,33,38,38881669,12664937,461432,,12203505,7684218
944,2023-08-02T00:00:00,1488,75,56,58,38883157,12664724,461447,,12203277,7684038
945,2023-08-03T00:00:00,1223,61,39,49,38884380,12664505,461468,,12203037,7683845
946,2023-08-04T00:00:00,1347,46,48,61,38885727,12664277,461463,,12202814,7683665
947,2023-08-05T00:00:00,1367,50,50,52,38887094,12664049,461459,,12202590,7683481
948,2023-08-06T00:00:00,599,25,20,25,38887693,12663833,461463,,12202370,7683293
949,2023-08-07T00:00:00,250,7,4,9,38887943,12663588,461460,,12202128,7683092
950,2023-08-08T00:00:00,340,9,5,15,38888283,12663349,461460,,12201889,7682890
951,2023-08-09T00:00:00,1332,45,40,50,38889615,12663113,461464,,12201649,7682698
952,2023-08-10T00:00:00,1678,95,53,72,38891293,12662967,461502,,12201465,7682561
953,2023-08-11T00:00:00,1731,58,48,65,38893024,12662773,461508,,12201265,7682412
954,2023-08-12T00:00:00,1733,65,48,71,38894757,12662606,461524,,12201082,7682288
955,2023-08-13T00:00:00,819,29,33,33,38895576,12662376,461519,,12200857,7682094
956,2023-08-14T00:00:00,255,6,2,6,38895831,12662136,461520,,12200616,7681888
957,2023-08-15T00:00:00,1334,38,27,42,38897165,12661853,461526,,12200327,7681663
958,2023-08-16T00:00:00,1706,60,51,52,38898871,12661643,461533,,12200110,7681483
959,2023-08-17T00:00:00,1777,79,67,65,38900648,12661451,461543,,12199908,7681309
960,2023-08-18T00:00:00,1757,86,60,55,38902405,12661236,461565,,12199671,7681110
961,2023-08-19T00:00:00,1789,81,54,72,38904194,12661031,461589,,12199442,7680937
962,2023-08-20T00:00:00,856,57,47,35,38905050,12660856,461594,,12199262,7680773
963,2023-08-21T00:00:00,238,4,2,9,38905288,12660548,461594,,12198954,7680520
964,2023-08-22T00:00:00,1294,56,48,51,38906582,12660295,461596,,12198699,7680312
965,2023-08-23T00:00:00,1601,68,51,55,38908183,12660097,461610,,12198487,7680142
966,2023-08-24T00:00:00,1652,95,68,74,38909835,12659889,461637,,12198252,7679950
967,2023-08-25T00:00:00,1525,87,44,61,38911360,12659676,461676,,12198000,7679759
968,2023-08-26T00:00:00,1728,79,56,72,38913088,12659481,461695,,12197786,7679597
969,2023-08-27T00:00:00,830,34,47,52,38913918,12659241,461677,,12197564,7679410
970,2023-08-28T00:00:00,201,5,3,9,38914119,12658995,461674,,12197321,7679201
971,2023-08-29T00:00:00,971,51,31,48,38915090,12658762,461690,,12197072,7678990
972,2023-08-30T00:00:00,1443,120,70,74,38916533,12658606,461737,,12196869,7678820
973,2023-08-31T00:00:00,1532,97,91,91,38918065,12658421,461739,,12196682,7678671
974,2023-09-01T00:00:00,1553,97,82,114,38919618,12658265,461749,,12196516,7678568
975,2023-09-02T00:00:00,1337,77,66,68,38920955,12658079,461758,,12196321,7678410
976,2023-09-03T00:00:00,700,48,41,35,38921655,12657877,461762,,12196115,7678228
977,2023-09-04T00:00:00,149,2,0,9,38921804,12657620,461759,,12195861,7678018
978,2023-09-05T00:00:00,141,6,3,7,38921945,12657353,461757,,12195596,7677795
979,2023-09-06T00:00:00,1063,45,39,58,38923008,12657089,461760,,12195329,7677588
980,2023-09-07T00:00:00,1303,55,38,76,38924311,12656845,461769,,12195076,7677410
981,2023-09-08T00:00:00,1118,67,43,49,38925429,12656637,461790,,12194847,7677223
982,2023-09-09T00:00:00,1281,62,41,73,38926710,12656409,461805,,12194604,7677046
983,2023-09-10T00:00:00,866,55,38,51,38927576,12656213,461819,,12194394,7676870
984,2023-09-11T00:00:00,135,5,4,8,38927711,12655975,461819,,12194156,7676662
985,2023-09-12T00:00:00,964,32,23,41,38928675,12655688,461823,,12193865,7676431
986,2023-09-13T00:00:00,1404,76,54,70,38930079,12655458,461840,,12193618,7676237
987,2023-09-14T00:00:00,1240,61,52,54,38931319,12655238,461845,,12193393,7676052
988,2023-09-15T00:00:00,1208,76,26,69,38932527,12655024,461892,,12193132,7675872
989,2023-09-16T00:00:00,1177,83,48,61,38933704,12654826,461925,,12192901,7675691
990,2023-09-17T00:00:00,714,57,31,53,38934418,12654624,461946,,12192678,7675520
991,2023-09-18T00:00:00,146,5,2,6,38934564,12654373,461946,,12192427,7675315
992,2023-09-19T00:00:00,919,62,32,54,38935483,12654099,461973,,12192126,7675087
993,2023-09-20T00:00:00,1033,80,36,52,38936516,12653913,462011,,12191902,7674904
994,2023-09-21T00:00:00,912,64,31,58,38937428,12653696,462039,,12191657,7674722
995,2023-09-22T00:00:00,898,58,34,67,38938326,12653455,462059,,12191396,7674528
996,2023-09-23T00:00:00,1011,70,56,57,38939337,12653240,462068,,12191172,7674345
997,2023-09-24T00:00:00,647,37,31,41,38939984,12653025,462071,,12190954,7674168
998,2023-09-25T00:00:00,133,5,4,10,38940117,12652754,462068,,12190686,7673942
999,2023-09-26T00:00:00,706,47,21,36,38940823,12652519,462093,,12190426,7673728
1000,2023-09-27T00:00:00,921,77,33,49,38941744,12652311,462133,,12190178,7673545
1001,2023-09-28T00:00:00,844,40,52,43,38942588,12652104,462116,,12189988,7673384
1002,2023-09-29T00:00:00,933,55,32,72,38943521,12651857,462134,,12189723,7673190
1003,2023-09-30T00:00:00,1012,58,31,49,38944533,12651616,462158,,12189458,7672969
1004,2023-10-01T00:00:00,484,34,19,19,38945017,12651373,462170,,12189203,7672747
1005,2023-10-02T00:00:00,133,5,2,10,38945150,12651122,462172,,12188950,7672535
1006,2023-10-03T00:00:00,908,32,9,50,38946058,12650847,462187,,12188660,7672330
1007,2023-10-04T00:00:00,2363,40,35,78,38948421,12650577,462187,,12188390,7672134
1008,2023-10-05T00:00:00,3019,54,33,86,38951440,12650337,462207,,12188130,7671969
1009,2023-10-06T00:00:00,4329,92,47,89,38955769,12650129,462247,,12187882,7671802
1010,2023-10-07T00:00:00,4622,91,64,162,38960391,12649967,462269,,12187698,7671738
1011,2023-10-08T00:00:00,766,36,21,45,38961157,12649712,462280,,12187432,7671531
1012,2023-10-09T00:00:00,145,4,2,5,38961302,12649452,462280,,12187172,7671294
1013,2023-10-10T00:00:00,89,4,1,4,38961391,12649204,462283,,12186921,7671074
1014,2023-10-11T00:00:00,8826,103,54,171,38970217,12649041,462332,,12186709,7671014
1015,2023-10-12T00:00:00,12669,132,92,251,38982886,12648856,462368,,12186488,7670993
1016,2023-10-13T00:00:00,13232,160,69,257,38996118,12648704,462455,,12186249,7670980
1017,2023-10-14T00:00:00,16925,175,106,297,39013043,12648613,462520,,12186093,7671041
1018,2023-10-15T00:00:00,9519,142,75,243,39022562,12648442,462583,,12185859,7671006
1019,2023-10-16T00:00:00,4563,52,31,52,39027125,12648180,462600,,12185580,7670787
1020,2023-10-17T00:00:00,24361,195,100,300,39051486,12648085,462692,,12185393,7670831
1021,2023-10-18T00:00:00,32510,290,149,434,39083996,12648083,462827,,12185256,7671012
1022,2023-10-19T00:00:00,36249,303,131,502,39120245,12648097,462994,,12185103,7671262
1023,2023-10-20T00:00:00,43579,344,164,541,39163824,12648141,463170,,12184971,7671540
1024,2023-10-21T00:00:00,45935,407,195,634,39209759,12648238,463380,,12184858,7671902
1025,2023-10-22T00:00:00,23724,261,139,525,39233483,12648178,463500,,12184678,7672145
1026,2023-10-23T00:00:00,8980,85,45,163,39242463,12648012,463540,,12184472,7672086
1027,2023-10-24T00:00:00,40925,298,147,505,39283388,12648029,463689,,12184340,7672353
1028,2023-10-25T00:00:00,46064,428,180,648,39329452,12648174,463930,,12184244,7672758
1029,2023-10-26T00:00:00,48086,436,184,716,39377538,12648279,464180,,12184099,7673195
1030,2023-10-27T00:00:00,53333,466,199,767,39430871,12648454,464444,,12184010,7673703
1031,2023-10-28T00:00:00,54842,499,242,852,39485713,12648684,464698,,12183986,7674311
1032,2023-10-29T00:00:00,23977,301,157,589,39509690,12648729,464834,,12183895,7674683
1033,2023-10-30T00:00:00,11599,133,53,266,39521289,12648599,464910,,12183689,7674718
1034,2023-10-31T00:00:00,56842,434,194,686,39578131,12648725,465144,,12183581,7675141
1035,2023-11-01T00:00:00,56797,499,199,672,39634928,12648917,465441,,12183476,7675545
1036,2023-11-02T00:00:00,62889,596,242,1073,39697817,12649223,465792,,12183431,7676365
1037,2023-11-03T00:00:00,65201,567,262,1243,39763018,12649485,466091,,12183394,7677347
1038,2023-11-04T00:00:00,63026,708,292,1230,39826044,12649877,466503,,12183374,7678306
1039,2023-11-05T00:00:00,34050,485,229,1123,39860094,12650035,466754,,12183281,7679164
1040,2023-11-06T00:00:00,14322,173,55,400,39874416,12649905,466869,,12183036,7679291
1041,2023-11-07T00:00:00,50003,546,214,873,39924419,12650110,467195,,12182915,7679865
1042,2023-11-08T00:00:00,55274,676,289,1117,39979693,12650519,467578,,12182941,7680755
1043,2023-11-09T00:00:00,55673,692,261,1295,40035366,12650947,468007,,12182940,7681824
1044,2023-11-10T00:00:00,53885,804,276,1161,40089251,12651460,468527,,12182933,7682739
1045,2023-11-11T00:00:00,50066,660,254,1268,40139317,12651772,468927,,12182845,7683707
1046,2023-11-12T00:00:00,24859,453,218,1037,40164176,12651952,469161,,12182791,7684504
1047,2023-11-13T00:00:00,11196,195,51,385,40175372,12651873,469303,,12182570,7684644
1048,2023-11-14T00:00:00,40054,488,199,885,40215426,12652068,469589,,12182479,7685278
1049,2023-11-15T00:00:00,45185,591,227,1107,40260611,12652315,469952,,12182363,7686088
1050,2023-11-16T00:00:00,43516,606,271,1158,40304127,12652616,470285,,12182331,7686969
1051,2023-11-17T00:00:00,41664,628,270,1094,40345791,12652923,470639,,12182284,7687785
1052,2023-11-18T00:00:00,39920,674,259,1311,40385711,12653261,471050,,12182211,7688810
1053,2023-11-19T00:00:00,22462,496,203,1102,40408173,12653484,471341,,12182143,7689676
1054,2023-11-20T00:00:00,9110,150,72,338,40417283,12653353,471414,,12181939,7689779
1055,2023-11-21T00:00:00,32616,464,195,829,40449899,12653521,471679,,12181842,7690362
1056,2023-11-22T00:00:00,35610,664,221,1006,40485509,12653886,472119,,12181767,7691101
1057,2023-11-23T00:00:00,34993,526,250,931,40520502,12654124,472386,,12181738,7691780
1058,2023-11-24T00:00:00,32873,515,198,922,40553375,12654376,472693,,12181683,7692486
1059,2023-11-25T00:00:00,31489,508,241,1108,40584864,12654589,472959,,12181630,7693330
1060,2023-11-26T00:00:00,16815,406,181,972,40601679,12654740,473181,,12181559,7694085
1061,2023-11-27T00:00:00,7040,124,47,331,40608719,12654577,473258,,12181319,7694168
1062,2023-11-28T00:00:00,25107,370,131,632,40633826,12654639,473494,,12181145,7694535
1063,2023-11-29T00:00:00,29804,485,197,949,40663630,12654806,473776,,12181030,7695219
1064,2023-11-30T00:00:00,28591,473,196,897,40692221,12654989,474048,,12180941,7695870
1065,2023-12-01T00:00:00,28616,446,198,883,40720837,12655124,474292,,12180832,7696481
1066,2023-12-02T00:00:00,25690,446,209,893,40746527,12655275,474526,,12180749,7697117
1067,2023-12-03T00:00:00,13578,333,172,738,40760105,12655333,474685,,12180648,7697611
1068,2023-12-04T00:00:00,6068,130,56,290,40766173,12655156,474755,,12180401,7697639
1069,2023-12-05T00:00:00,20444,292,130,660,40786617,12655141,474915,,12180226,7698035
1070,2023-12-06T00:00:00,25459,398,177,794,40812076,12655241,475130,,12180111,7698564
1071,2023-12-07T00:00:00,24430,400,199,807,40836506,12655391,475330,,12180061,7699145
1072,2023-12-08T00:00:00,22847,432,192,777,40859353,12655516,475564,,12179952,7699652
1073,2023-12-09T00:00:00,23304,412,234,821,40882657,12655631,475737,,12179894,7700217
1074,2023-12-10T00:00:00,13640,366,189,866,40896297,12655688,475908,,12179780,7700809
1075,2023-12-11T00:00:00,6608,116,51,340,40902905,12655538,475970,,12179568,7700921
1076,2023-12-12T00:00:00,20973,324,163,666,40923878,12655543,476124,,12179419,7701310
1077,2023-12-13T00:00:00,20293,368,168,741,40944171,12655602,476320,,12179282,7701769
1078,2023-12-14T00:00:00,17953,353,161,764,40962124,12655676,476507,,12179169,7702306
1079,2023-12-15T00:00:00,17993,276,154,611,40980117,12655676,476628,,12179048,7702668
1080,2023-12-16T00:00:00,17779,362,174,692,40997896,12655709,476814,,12178895,7703074
1081,2023-12-17T00:00:00,8969,238,142,608,41006865,12655689,476905,,12178784,7703464
1082,2023-12-18T00:00:00,4247,99,45,241,41011112,12655531,476958,,12178573,7703479
1083,2023-12-19T00:00:00,14805,284,121,587,41025917,12655491,477118,,12178373,7703774
1084,2023-12-20T00:00:00,14767,354,153,547,41040684,12655596,477314,,12178282,7704099
1085,2023-12-21T00:00:00,14747,320,127,630,41055431,12655622,477503,,12178119,7704471
1086,2023-12-22T00:00:00,13342,289,120,547,41068773,12655619,477668,,12177951,7704763
1087,2023-12-23T00:00:00,10608,299,117,440,41079381,12655612,477847,,12177765,7704937
1088,2023-12-24T00:00:00,3930,122,48,243,41083311,12655427,477915,,12177512,7704920
1089,2023-12-25T00:00:00,1341,56,10,88,41084652,12655209,477959,,12177250,7704760
1090,2023-12-26T00:00:00,190,15,7,12,41084842,12654952,477964,,12176988,7704539
1091,2023-12-27T00:00:00,1452,50,10,60,41086294,12654737,478001,,12176736,7704370
1092,2023-12-28T00:00:00,6724,191,77,295,41093018,12654623,478113,,12176510,7704402
1093,2023-12-29T00:00:00,7176,202,92,356,41100194,12654512,478221,,12176291,7704484
1094,2023-12-30T00:00:00,6475,219,80,310,41106669,12654421,478359,,12176062,7704530
1095,2023-12-31T00:00:00,2709,119,34,126,41109378,12654228,478440,,12175788,7704389
1096,2024-01-01T00:00:00,1021,39,10,69,41110399,12653996,478462,,12175534,7704237
1097,2024-01-02T00:00:00,425,17,1,18,41110824,12653753,478474,,12175279,7704031
1098,2024-01-03T00:00:00,5738,190,85,280,41116562,12653635,478577,,12175058,7704043
1099,2024-01-04T00:00:00,7465,263,109,358,41124027,12653607,478729,,12174878,7704151
1100,2024-01-05T00:00:00,7936,265,123,382,41131963,12653571,478870,,12174701,7704270
1101,2024-01-06T00:00:00,8471,245,150,425,41140434,12653499,478962,,12174537,7704418
1102,2024-01-07T00:00:00,3974,172,82,217,41144408,12653408,479049,,12174359,7704402
1103,2024-01-08T00:00:00,1697,65,7,109,41146105,12653185,479103,,12174082,7704270
1104,2024-01-09T00:00:00,5620,182,66,202,41151725,12653080,479215,,12173865,7704222
1105,2024-01-10T00:00:00,4580,142,75,188,41156305,12652895,479275,,12173620,7704129
1106,2024-01-11T00:00:00,5024,154,77,203,41161329,12652747,479351,,12173396,7704068
1107,2024-01-12T00:00:00,5114,119,72,210,41166443,12652618,479394,,12173224,7704056
1108,2024-01-13T00:00:00,6079,184,125,268,41172522,12652562,479448,,12173114,7704116
1109,2024-01-14T00:00:00,2411,90,33,175,41174933,12652392,479501,,12172891,7704064
1110,2024-01-15T00:00:00,1349,42,15,72,41176282,12652191,479526,,12172665,7703918
1111,2024-01-16T00:00:00,3979,191,71,160,41180261,12652131,479643,,12172488,7703858
1112,2024-01-17T00:00:00,3738,154,64,191,41183999,12652028,479730,,12172298,7703816
1113,2024-01-18T00:00:00,3853,121,85,179,41187852,12651903,479763,,12172140,7703788
1114,2024-01-19T00:00:00,4023,145,86,179,41191875,12651782,479817,,12171965,7703741
1115,2024-01-20T00:00:00,4296,200,111,193,41196171,12651717,479903,,12171814,7703706
1116,2024-01-21T00:00:00,2025,91,58,100,41198196,12651572,479933,,12171639,7703600
1117,2024-01-22T00:00:00,830,43,16,47,41199026,12651391,479960,,12171431,7703448
1118,2024-01-23T00:00:00,3039,102,48,120,41202065,12651235,480012,,12171223,7703353
1119,2024-01-24T00:00:00,2787,126,50,132,41204852,12651126,480084,,12171042,7703280
1120,2024-01-25T00:00:00,2896,140,91,137,41207748,12650985,480129,,12170856,7703161
1121,2024-01-26T00:00:00,2967,113,52,108,41210715,12650860,480189,,12170671,7703058
1122,2024-01-27T00:00:00,3047,113,93,146,41213762,12650722,480208,,12170514,7702978
1123,2024-01-28T00:00:00,1545,74,47,88,41215307,12650550,480233,,12170317,7702840
1124,2024-01-29T00:00:00,631,26,10,41,41215938,12650321,480245,,12170076,7702650
1125,2024-01-30T00:00:00,2357,93,56,109,41218295,12650153,480280,,12169873,7702543
1126,2024-01-31T00:00:00,2571,106,63,126,41220866,12650017,480323,,12169694,7702449
1127,2024-02-01T00:00:00,2590,111,55,95,41223456,12649856,480371,,12169485,7702302
1128,2024-02-02T00:00:00,2163,83,54,91,41225619,12649692,480397,,12169295,7702169
1129,2024-02-03T00:00:00,2662,102,79,101,41228281,12649554,480419,,12169135,7702051
1130,2024-02-04T00:00:00,1155,66,27,60,41229436,12649430,480455,,12168975,7701940
1131,2024-02-05T00:00:00,614,40,17,27,41230050,12649248,480475,,12168773,7701773
1132,2024-02-06T00:00:00,2045,96,51,83,41232095,12649111,480516,,12168595,7701652
1133,2024-02-07T00:00:00,2025,72,59,79,41234120,12648963,480527,,12168436,7701534
1134,2024-02-08T00:00:00,2001,94,70,106,41236121,12648836,480551,,12168285,7701448
1135,2024-02-09T00:00:00,1998,76,56,90,41238119,12648689,480568,,12168121,7701347
1136,2024-02-10T00:00:00,2151,105,81,90,41240270,12648560,480591,,12167969,7701230
1137,2024-02-11T00:00:00,1016,48,30,38,41241286,12648417,480608,,12167809,7701102
1138,2024-02-12T00:00:00,409,20,6,25,41241695,12648254,480620,,12167634,7700961
1139,2024-02-13T00:00:00,1735,73,36,75,41243430,12648109,480655,,12167454,7700842
1140,2024-02-14T00:00:00,1547,65,45,78,41244977,12647959,480675,,12167284,7700726
1141,2024-02-15T00:00:00,1388,50,54,84,41246365,12647780,480668,,12167112,7700599
1142,2024-02-16T00:00:00,1283,74,38,52,41247648,12647633,480703,,12166930,7700457
1143,2024-02-17T00:00:00,1936,91,52,99,41249584,12647523,480741,,12166782,7700380
1144,2024-02-18T00:00:00,729,50,15,48,41250313,12647370,480773,,12166597,7700247
1145,2024-02-19T00:00:00,355,24,4,23,41250668,12647207,480790,,12166417,7700109
1146,2024-02-20T00:00:00,335,14,4,18,41251003,12647028,480800,,12166228,7699953
1147,2024-02-21T00:00:00,1572,95,45,74,41252575,12646899,480848,,12166051,7699819
1148,2024-02-22T00:00:00,1515,77,43,75,41254090,12646763,480882,,12165881,7699702
1149,2024-02-23T00:00:00,1535,83,46,68,41255625,12646626,480914,,12165712,7699575
1150,2024-02-24T00:00:00,1692,89,56,92,41257317,12646518,480943,,12165575,7699492
1151,2024-02-25T00:00:00,688,32,16,45,41258005,12646381,480959,,12165422,7699393
1152,2024-02-26T00:00:00,391,15,4,38,41258396,12646225,480968,,12165257,7699280
1153,2024-02-27T00:00:00,1388,64,53,64,41259784,12646099,480979,,12165120,7699171
1154,2024-02-28T00:00:00,1188,75,29,62,41260972,12645970,481022,,12164948,7699057
1155,2024-02-29T00:00:00,1181,72,49,70,41262153,12645866,481045,,12164821,7698966
1156,2024-03-01T00:00:00,1125,79,32,64,41263278,12645760,481091,,12164669,7698864
1157,2024-03-02T00:00:00,1459,73,27,66,41264737,12645659,481133,,12164526,7698780
1158,2024-03-03T00:00:00,695,30,13,33,41265432,12645515,481150,,12164365,7698647
1159,2024-03-04T00:00:00,347,15,4,22,41265779,12645366,481158,,12164208,7698532
1160,2024-03-05T00:00:00,1116,54,25,63,41266895,12645261,481184,,12164077,7698454
1161,2024-03-06T00:00:00,1184,56,36,45,41268079,12645151,481204,,12163947,7698358
1162,2024-03-07T00:00:00,1245,45,36,54,41269324,12645034,481212,,12163822,7698266
1163,2024-03-08T00:00:00,1066,62,23,50,41270390,12644947,481250,,12163697,7698185
1164,2024-03-09T00:00:00,1223,74,23,64,41271613,12644858,481298,,12163560,7698107
1165,2024-03-10T00:00:00,675,29,10,36,41272288,12644728,481313,,12163415,7698007
1166,2024-03-11T00:00:00,274,15,4,18,41272562,12644623,481322,,12163301,7697913
1167,2024-03-12T00:00:00,1087,62,36,44,41273649,12644533,481346,,12163187,7697818
1168,2024-03-13T00:00:00,1031,55,16,59,41274680,12644454,481385,,12163069,7697760
1169,2024-03-14T00:00:00,1046,43,32,53,41275726,12644361,481395,,12162966,7697700
1170,2024-03-15T00:00:00,1131,52,20,45,41276857,12644294,481427,,12162867,7697641
1171,2024-03-16T00:00:00,1229,56,31,51,41278086,12644220,481451,,12162769,7697575
1172,2024-03-17T00:00:00,504,22,8,37,41278590,12644136,481464,,12162672,7697517
1173,2024-03-18T00:00:00,204,11,3,19,41278794,12644032,481470,,12162562,7697431
1174,2024-03-19T00:00:00,981,40,22,49,41279775,12643961,481487,,12162474,7697378
1175,2024-03-20T00:00:00,885,43,23,48,41280660,12643903,481506,,12162397,7697336
1176,2024-03-21T00:00:00,932,42,32,38,41281592,12643850,481516,,12162334,7697291
1177,2024-03-22T00:00:00,956,58,26,47,41282548,12643841,481548,,12162293,7697279
1178,2024-03-23T00:00:00,983,46,34,57,41283531,12643804,481558,,12162246,7697262
1179,2024-03-24T00:00:00,426,26,13,21,41283957,12643751,481571,,12162180,7697213
1180,2024-03-25T00:00:00,211,9,3,22,41284168,12643674,481577,,12162097,7697162
1181,2024-03-26T00:00:00,946,67,26,48,41285114,12643681,481616,,12162065,7697160
1182,2024-03-27T00:00:00,766,43,22,44,41285880,12643670,481637,,12162033,7697157
1183,2024-03-28T00:00:00,820,43,27,45,41286700,12643703,481653,,12162050,7697193
1184,2024-03-29T00:00:00,965,53,29,32,41287665,12643753,481677,,12162076,7697222
1185,2024-03-30T00:00:00,183,11,2,13,41287848,12643764,481686,,12162078,7697235
1186,2024-03-31T00:00:00,343,21,10,24,41288191,12643785,481697,,12162088,7697259
1187,2024-04-01T00:00:00,82,4,2,5,41288273,12643789,481699,,12162090,7697264
1188,2024-04-02T00:00:00,635,30,10,29,41288908,12643819,481719,,12162100,7697293
1189,2024-04-03T00:00:00,859,45,18,36,41289767,12643864,481746,,12162118,7697329
